Player,Pos,Age,G,GS,MP,FG,FGA,FG%,3P,3PA,3P%,2P,2PA,2P%,eFG%,FT,FTA,FT%,ORB,DRB,TRB,AST,STL,BLK,TOV,PF,PTS
Shareef Abdur-Rahim\abdursh01,PF,31,6,0,51,3,14,0.214,0,0,,3,14,0.214,0.214,4,4,1,6,4,10,4,1,0,1,9,10
Arron Afflalo\afflaar01,SG,22,75,9,970,99,241,0.411,10,48,0.208,89,193,0.461,0.432,68,87,0.782,36,101,137,52,31,8,34,83,276
Maurice Ager\agerma01,SG,23,26,3,165,21,65,0.323,3,19,0.158,18,46,0.391,0.346,6,12,0.5,4,9,13,8,0,1,6,17,51
Maurice Ager\agerma01,SG,23,12,3,77,5,27,0.185,0,8,0,5,19,0.263,0.185,5,6,0.833,1,3,4,4,0,1,3,11,15
Maurice Ager\agerma01,SG,23,14,0,88,16,38,0.421,3,11,0.273,13,27,0.481,0.461,1,6,0.167,3,6,9,4,0,0,3,6,36
Blake Ahearn\ahearbl01,PG,23,12,0,177,15,57,0.263,10,34,0.294,5,23,0.217,0.351,30,31,0.968,1,18,19,19,6,0,16,20,70
LaMarcus Aldridge\aldrila01,PF,22,76,76,2649,561,1160,0.484,1,7,0.143,560,1153,0.486,0.484,227,298,0.762,220,358,578,122,55,94,126,240,1350
Malik Allen\allenma01,PF,29,73,16,1096,157,327,0.48,1,2,0.5,156,325,0.48,0.482,23,25,0.92,66,130,196,44,19,31,45,149,338
Malik Allen\allenma01,PF,29,48,12,763,124,261,0.475,1,2,0.5,123,259,0.475,0.477,12,13,0.923,42,86,128,29,15,21,32,89,261
Malik Allen\allenma01,PF,29,25,4,333,33,66,0.5,0,0,,33,66,0.5,0.5,11,12,0.917,24,44,68,15,4,10,13,60,77
Ray Allen*\allenra02,SG,32,73,73,2624,439,986,0.445,180,452,0.398,259,534,0.485,0.537,215,237,0.907,75,193,268,225,65,16,127,147,1273
Tony Allen\allento01,SG,26,75,11,1373,169,389,0.434,18,57,0.316,151,332,0.455,0.458,138,181,0.762,34,134,168,114,62,21,109,168,494
Lance Allred\allrela01,C,26,3,0,10,1,4,0.25,0,0,,1,4,0.25,0.25,1,2,0.5,0,1,1,0,0,0,0,1,3
Morris Almond\almonmo01,SG,22,9,0,39,4,15,0.267,1,4,0.25,3,11,0.273,0.3,4,6,0.667,0,2,2,3,1,0,2,5,13
Rafer Alston\alstora01,PG,31,74,74,2526,364,924,0.394,143,407,0.351,221,517,0.427,0.471,98,137,0.715,28,232,260,392,98,18,160,139,969
Lou Amundson\amundlo01,PF,25,16,0,64,8,16,0.5,0,0,,8,16,0.5,0.5,2,7,0.286,7,5,12,0,1,1,2,13,18
Chris Andersen\anderch01,C,29,5,0,34,2,7,0.286,0,0,,2,7,0.286,0.286,2,4,0.5,2,7,9,0,0,4,1,6,6
Derek Anderson\anderde01,SG,33,28,0,396,47,125,0.376,19,52,0.365,28,73,0.384,0.452,28,38,0.737,9,43,52,44,12,1,25,49,141
Carmelo Anthony\anthoca01,SF,23,77,77,2806,728,1481,0.492,58,164,0.354,670,1317,0.509,0.511,464,590,0.786,178,393,571,259,98,39,253,253,1978
Joel Anthony\anthojo01,PF,25,24,1,498,28,60,0.467,0,0,,28,60,0.467,0.467,29,49,0.592,38,55,93,3,9,31,17,55,85
Gilbert Arenas\arenagi01,PG,26,13,8,425,78,196,0.398,22,78,0.282,56,118,0.475,0.454,74,96,0.771,6,45,51,66,23,1,49,30,252
Trevor Ariza\arizatr01,SF,22,35,3,546,69,136,0.507,5,18,0.278,64,118,0.542,0.526,49,75,0.653,30,78,108,44,31,11,23,45,192
Trevor Ariza\arizatr01,SF,22,11,0,115,14,31,0.452,0,3,0,14,28,0.5,0.452,8,15,0.533,5,19,24,8,5,3,5,9,36
Trevor Ariza\arizatr01,SF,22,24,3,431,55,105,0.524,5,15,0.333,50,90,0.556,0.548,41,60,0.683,25,59,84,36,26,8,18,36,156
Darrell Armstrong\armstda01,PG,39,50,2,549,40,110,0.364,23,69,0.333,17,41,0.415,0.468,20,30,0.667,17,50,67,73,28,2,41,53,123
Hilton Armstrong\armsthi01,C,23,65,3,732,67,148,0.453,0,0,,67,148,0.453,0.453,44,70,0.629,65,98,163,23,15,34,59,130,178
Carlos Arroyo\arroyca01,PG,28,62,20,1269,157,348,0.451,29,84,0.345,128,264,0.485,0.493,87,102,0.853,10,103,113,219,26,2,77,85,430
Chucky Atkins\atkinch01,SG,33,24,0,352,42,122,0.344,25,79,0.316,17,43,0.395,0.447,4,9,0.444,3,28,31,47,9,1,10,27,113
James Augustine\augusja01,PF,23,25,0,149,18,34,0.529,0,0,,18,34,0.529,0.529,4,8,0.5,16,14,30,2,5,2,6,18,40
Kelenna Azubuike\azubuke01,SG,24,81,17,1732,261,587,0.445,71,195,0.364,190,392,0.485,0.505,99,138,0.717,107,217,324,75,45,34,58,159,692
Renaldo Balkman\balkmre01,SF,23,65,0,952,91,186,0.489,1,12,0.083,90,174,0.517,0.492,41,95,0.432,83,133,216,40,44,30,37,132,224
Marcus Banks\banksma01,PG,26,36,3,569,86,191,0.45,40,102,0.392,46,89,0.517,0.555,27,35,0.771,4,41,45,61,14,13,37,65,239
Marcus Banks\banksma01,PG,26,24,1,310,44,109,0.404,25,65,0.385,19,44,0.432,0.518,12,16,0.75,3,17,20,25,8,8,16,38,125
Marcus Banks\banksma01,PG,26,12,2,259,42,82,0.512,15,37,0.405,27,45,0.6,0.604,15,19,0.789,1,24,25,36,6,5,21,27,114
Leandro Barbosa\barbole01,SG,25,82,12,2421,472,1021,0.462,164,422,0.389,308,599,0.514,0.543,175,213,0.822,40,191,231,216,75,18,117,195,1283
J.J. Barea\bareajo01,PG,23,44,9,460,71,170,0.418,21,54,0.389,50,116,0.431,0.479,28,35,0.8,4,43,47,58,14,1,35,48,191
Andrea Bargnani\bargnan01,PF,22,78,53,1861,280,725,0.386,90,261,0.345,190,464,0.409,0.448,142,169,0.84,50,238,288,89,23,37,88,211,792
Matt Barnes\barnema02,PF,27,73,18,1414,187,442,0.423,53,181,0.293,134,261,0.513,0.483,59,79,0.747,94,230,324,139,48,36,85,159,486
Andre Barrett\barrean01,PG,25,4,0,25,2,5,0.4,1,3,0.333,1,2,0.5,0.5,1,2,0.5,0,1,1,7,0,0,1,1,6
Earl Barron\barroea01,C,26,46,15,889,132,327,0.404,1,13,0.077,131,314,0.417,0.405,61,87,0.701,67,131,198,29,19,8,48,114,326
Brent Barry\barrybr01,SF,36,31,1,554,77,160,0.481,48,112,0.429,29,48,0.604,0.631,19,20,0.95,12,43,55,54,17,3,18,43,221
Brandon Bass\bassbr01,C,22,79,1,1557,246,493,0.499,0,4,0,246,489,0.503,0.499,162,197,0.822,120,227,347,58,22,48,82,150,654
Maceo Baston\bastoma01,PF,32,15,2,103,17,25,0.68,0,0,,17,25,0.68,0.68,7,10,0.7,9,17,26,3,2,4,4,20,41
Shane Battier\battish01,SF,29,80,78,2907,265,619,0.428,139,369,0.377,126,250,0.504,0.54,75,101,0.743,131,276,407,155,77,90,78,196,744
Marco Belinelli\belinma01,SG,21,33,0,241,36,93,0.387,16,41,0.39,20,52,0.385,0.473,7,9,0.778,3,11,14,15,5,0,12,15,95
Charlie Bell\bellch01,SG,28,68,5,1628,185,486,0.381,74,217,0.341,111,269,0.413,0.457,70,87,0.805,31,136,167,210,52,2,76,121,514
Raja Bell\bellra01,SG,31,75,75,2646,317,753,0.421,176,439,0.401,141,314,0.449,0.538,79,91,0.868,47,227,274,168,54,27,65,220,889
Mike Bibby\bibbymi01,PG,29,48,44,1573,248,603,0.411,93,248,0.375,155,355,0.437,0.488,78,100,0.78,16,144,160,290,54,4,119,97,667
Mike Bibby\bibbymi01,PG,29,15,12,473,78,192,0.406,24,61,0.393,54,131,0.412,0.469,23,31,0.742,11,45,56,75,19,2,38,34,203
Mike Bibby\bibbymi01,PG,29,33,32,1100,170,411,0.414,69,187,0.369,101,224,0.451,0.498,55,69,0.797,5,99,104,215,35,2,81,63,464
Andris Biedrins\biedran01,C,21,76,59,2078,340,543,0.626,0,0,,340,543,0.626,0.626,116,187,0.62,256,488,744,75,56,94,85,262,796
Chauncey Billups\billuch01,PG,31,78,78,2522,393,877,0.448,137,342,0.401,256,535,0.479,0.526,401,437,0.918,42,170,212,529,101,17,160,130,1324
Steve Blake\blakest01,PG,27,81,78,2424,261,640,0.408,121,298,0.406,140,342,0.409,0.502,49,64,0.766,31,164,195,413,55,4,113,133,692
Andray Blatche\blatcan01,PF,21,82,15,1675,254,536,0.474,3,13,0.231,251,523,0.48,0.477,107,154,0.695,164,261,425,92,53,114,112,258,618
Mark Blount\blounma01,C,32,69,46,1542,238,515,0.462,17,44,0.386,221,471,0.469,0.479,88,138,0.638,69,194,263,41,33,34,70,133,581
Keith Bogans\boganke01,SG,27,82,35,2198,241,588,0.41,148,409,0.362,93,179,0.52,0.536,81,110,0.736,42,224,266,104,59,10,53,164,711
Andrew Bogut\bogutan01,C,23,78,78,2720,465,910,0.511,0,7,0,465,903,0.515,0.511,189,322,0.587,245,518,763,199,64,135,172,254,1119
Matt Bonner\bonnema01,PF,27,68,3,853,121,291,0.416,46,137,0.336,75,154,0.487,0.495,38,44,0.864,53,139,192,32,14,17,39,111,326
Josh Boone\boonejo01,PF,23,70,53,1773,238,434,0.548,0,0,,238,434,0.548,0.548,99,217,0.456,192,317,509,55,36,61,68,155,575
Calvin Booth\boothca01,C,31,31,0,204,9,27,0.333,0,0,,9,27,0.333,0.333,6,10,0.6,6,32,38,8,6,18,4,35,24
Carlos Boozer\boozeca01,PF,26,81,81,2827,709,1297,0.547,0,1,0,709,1296,0.547,0.547,290,393,0.738,197,647,844,233,100,41,210,293,1708
Chris Bosh\boshch01,C,23,67,67,2425,507,1027,0.494,10,25,0.4,497,1002,0.496,0.499,472,559,0.844,174,409,583,171,63,67,153,157,1496
Bruce Bowen\bowenbr01,SF,36,81,81,2448,174,428,0.407,90,215,0.419,84,213,0.394,0.512,45,69,0.652,33,201,234,91,54,22,46,177,483
Ryan Bowen\bowenry01,SF,32,53,4,660,49,100,0.49,0,1,0,49,99,0.495,0.49,16,29,0.552,55,45,100,25,32,11,15,77,114
Earl Boykins\boykiea01,PG,31,36,0,577,61,172,0.355,14,44,0.318,47,128,0.367,0.395,49,59,0.831,9,25,34,96,13,0,41,21,185
Elton Brand\brandel01,PF,28,8,6,274,52,114,0.456,0,0,,52,114,0.456,0.456,37,47,0.787,21,43,64,16,3,15,17,21,141
Corey Brewer\breweco01,SF,21,79,35,1803,182,486,0.374,7,36,0.194,175,450,0.389,0.382,88,110,0.8,82,210,292,111,76,25,89,188,459
Ronnie Brewer\brewero02,SG,22,76,76,2088,354,634,0.558,11,50,0.22,343,584,0.587,0.567,195,257,0.759,97,121,218,134,129,19,69,110,914
Primoz Brezec\brezepr01,C,28,50,18,475,44,94,0.468,0,0,,44,94,0.468,0.468,24,40,0.6,30,51,81,11,3,7,24,83,112
Primoz Brezec\brezepr01,C,28,20,18,267,17,43,0.395,0,0,,17,43,0.395,0.395,3,5,0.6,14,30,44,6,0,3,15,35,37
Primoz Brezec\brezepr01,C,28,17,0,98,10,13,0.769,0,0,,10,13,0.769,0.769,7,14,0.5,7,12,19,4,2,2,5,23,27
Primoz Brezec\brezepr01,C,28,13,0,110,17,38,0.447,0,0,,17,38,0.447,0.447,14,21,0.667,9,9,18,1,1,2,4,25,48
Aaron Brooks\brookaa01,PG,23,51,0,608,93,225,0.413,36,109,0.33,57,116,0.491,0.493,42,49,0.857,13,43,56,87,13,5,44,69,264
Andre Brown\brownan01,PF,26,33,1,286,39,78,0.5,0,0,,39,78,0.5,0.5,22,49,0.449,37,55,92,8,7,4,14,38,100
Devin Brown\brownde02,SG,29,78,20,1762,217,531,0.409,45,146,0.308,172,385,0.447,0.451,107,142,0.754,65,198,263,175,52,7,99,144,586
Kwame Brown\brownkw01,C,25,38,15,713,72,142,0.507,0,0,,72,142,0.507,0.507,40,98,0.408,51,137,188,45,22,23,51,82,184
Kwame Brown\brownkw01,C,25,23,14,509,53,103,0.515,0,0,,53,103,0.515,0.515,26,64,0.406,31,100,131,28,16,19,37,58,132
Kwame Brown\brownkw01,C,25,15,1,204,19,39,0.487,0,0,,19,39,0.487,0.487,14,34,0.412,20,37,57,17,6,4,14,24,52
P.J. Brown\brownpj01,PF,38,18,0,209,14,41,0.341,0,1,0,14,40,0.35,0.341,11,16,0.688,29,39,68,10,5,8,10,29,39
Shannon Brown\brownsh01,SG,22,21,4,240,44,126,0.349,9,30,0.3,35,96,0.365,0.385,17,29,0.586,6,14,20,17,11,3,24,29,114
Shannon Brown\brownsh01,SG,22,15,4,218,41,111,0.369,9,29,0.31,32,82,0.39,0.41,14,23,0.609,5,13,18,17,10,1,19,27,105
Shannon Brown\brownsh01,SG,22,6,0,22,3,15,0.2,0,1,0,3,14,0.214,0.2,3,6,0.5,1,1,2,0,1,2,5,2,9
Kobe Bryant\bryanko01,SG,29,82,82,3192,775,1690,0.459,150,415,0.361,625,1275,0.49,0.503,623,742,0.84,94,423,517,441,151,40,257,227,2323
Greg Buckner\buckngr01,SG,31,31,4,520,45,117,0.385,15,50,0.3,30,67,0.448,0.449,19,22,0.864,10,55,65,39,21,2,29,63,124
Caron Butler\butleca01,SF,27,58,58,2314,439,943,0.466,66,185,0.357,373,758,0.492,0.501,236,262,0.901,93,295,388,284,128,20,150,160,1180
Rasual Butler\butlera01,SF,28,51,8,875,91,260,0.35,44,133,0.331,47,127,0.37,0.435,26,31,0.839,16,84,100,36,15,21,10,66,252
Andrew Bynum\bynuman01,C,20,35,25,1008,189,297,0.636,0,0,,189,297,0.636,0.636,82,118,0.695,105,251,356,61,12,72,52,98,460
Jose Calderon\caldejo01,PG,26,82,56,2484,367,707,0.519,79,184,0.429,288,523,0.551,0.575,109,120,0.908,34,202,236,678,87,6,126,134,922
Marcus Camby\cambyma01,C,33,79,79,2758,286,635,0.45,6,20,0.3,280,615,0.455,0.455,143,202,0.708,230,807,1037,259,85,285,118,216,721
Brian Cardinal\cardibr01,PF,30,37,1,440,43,126,0.341,25,81,0.309,18,45,0.4,0.44,13,19,0.684,26,70,96,22,10,2,23,62,124
Rodney Carney\carnero01,SF,23,70,6,1039,158,392,0.403,38,120,0.317,120,272,0.441,0.452,55,81,0.679,50,99,149,32,39,23,34,96,409
Matt Carroll\carroma01,SG,27,80,18,2016,252,589,0.428,105,241,0.436,147,348,0.422,0.517,111,138,0.804,33,193,226,73,46,19,58,187,720
Anthony Carter\cartean01,PG,32,70,67,1960,218,476,0.458,45,129,0.349,173,347,0.499,0.505,64,85,0.753,27,173,200,388,107,28,124,172,545
Vince Carter\cartevi01,SG,31,76,72,2959,587,1287,0.456,98,273,0.359,489,1014,0.482,0.494,350,429,0.816,112,341,453,389,93,33,181,241,1622
Sam Cassell\cassesa01,PG,38,55,34,1274,233,532,0.438,23,76,0.303,210,456,0.461,0.46,127,144,0.882,17,119,136,214,37,6,97,98,616
Sam Cassell\cassesa01,PG,38,38,33,975,183,402,0.455,14,54,0.259,169,348,0.486,0.473,106,119,0.891,12,93,105,179,28,3,78,69,486
Sam Cassell\cassesa01,PG,38,17,1,299,50,130,0.385,9,22,0.409,41,108,0.38,0.419,21,25,0.84,5,26,31,35,9,3,19,29,130
Tyson Chandler\chandty01,C,25,79,79,2783,377,605,0.623,0,1,0,377,604,0.624,0.623,175,295,0.593,322,606,928,81,45,84,136,243,929
Wilson Chandler\chandwi01,SF,20,35,16,685,106,242,0.438,9,30,0.3,97,212,0.458,0.457,34,54,0.63,38,89,127,33,15,16,27,83,255
Josh Childress\childjo01,SF,24,76,0,2274,327,573,0.571,22,60,0.367,305,513,0.595,0.59,222,275,0.807,174,199,373,117,71,43,98,129,898
Jarron Collins\collija03,C,29,70,9,702,36,82,0.439,0,1,0,36,81,0.444,0.439,46,74,0.622,40,76,116,37,10,6,22,106,118
Jason Collins\collija04,C,29,74,26,1172,53,113,0.469,0,1,0,53,112,0.473,0.469,34,74,0.459,64,114,178,25,23,25,48,194,140
Jason Collins\collija04,C,29,43,23,684,23,54,0.426,0,0,,23,54,0.426,0.426,14,36,0.389,35,54,89,19,11,8,23,110,60
Jason Collins\collija04,C,29,31,3,488,30,59,0.508,0,1,0,30,58,0.517,0.508,20,38,0.526,29,60,89,6,12,17,25,84,80
Mardy Collins\collima01,SG,23,46,8,634,57,175,0.326,8,32,0.25,49,143,0.343,0.349,23,38,0.605,19,56,75,89,24,8,56,56,145
Nick Collison\collini01,PF,27,78,35,2223,322,641,0.502,0,2,0,322,639,0.504,0.502,123,167,0.737,254,476,730,113,47,60,118,250,767
Mike Conley\conlemi01,PG,20,53,46,1381,189,442,0.428,30,91,0.33,159,351,0.453,0.462,90,123,0.732,21,118,139,222,44,2,89,85,498
Brian Cook\cookbr01,PF,27,51,2,629,88,234,0.376,43,115,0.374,45,119,0.378,0.468,19,21,0.905,28,81,109,27,13,12,39,93,238
Brian Cook\cookbr01,PF,27,6,2,70,4,21,0.19,2,10,0.2,2,11,0.182,0.238,4,4,1,4,6,10,3,2,0,4,6,14
Brian Cook\cookbr01,PF,27,45,0,559,84,213,0.394,41,105,0.39,43,108,0.398,0.491,15,17,0.882,24,75,99,24,11,12,35,87,224
Daequan Cook\cookda02,SG,20,59,19,1441,196,514,0.381,79,238,0.332,117,276,0.424,0.458,47,57,0.825,20,157,177,75,23,9,63,157,518
Jamal Crawford\crawfja01,SG,27,80,80,3190,570,1391,0.41,176,494,0.356,394,897,0.439,0.473,329,381,0.864,37,170,207,398,81,17,192,144,1645
Javaris Crittenton\crittja01,SG,20,50,0,679,98,233,0.421,10,37,0.27,88,196,0.449,0.442,72,104,0.692,27,83,110,51,19,2,55,47,278
Javaris Crittenton\crittja01,SG,20,22,0,171,26,53,0.491,1,3,0.333,25,50,0.5,0.5,19,28,0.679,7,14,21,18,7,0,22,12,72
Javaris Crittenton\crittja01,SG,20,28,0,508,72,180,0.4,9,34,0.265,63,146,0.432,0.425,53,76,0.697,20,69,89,33,12,2,33,35,206
Austin Croshere\croshau01,PF,32,44,0,457,61,137,0.445,22,61,0.361,39,76,0.513,0.526,29,32,0.906,33,71,104,30,8,6,22,60,173
Eddy Curry\curryed01,C,25,59,58,1530,297,544,0.546,0,0,,297,544,0.546,0.546,187,300,0.623,111,164,275,32,14,29,126,157,781
Samuel Dalembert\dalemsa01,C,26,82,82,2724,339,661,0.513,0,1,0,339,660,0.514,0.513,186,263,0.707,304,545,849,45,40,192,155,269,864
Erick Dampier\dampier01,C,32,72,64,1755,178,277,0.643,0,0,,178,277,0.643,0.643,84,146,0.575,207,332,539,63,24,106,80,226,440
Antonio Daniels\daniean01,PG,32,71,63,2161,205,447,0.459,17,74,0.23,188,373,0.504,0.478,170,219,0.776,23,180,203,340,69,2,91,78,597
Marquis Daniels\daniema01,SG,27,74,1,1546,241,561,0.43,27,102,0.265,214,459,0.466,0.454,97,139,0.698,66,146,212,137,79,18,112,121,606
Jermareo Davidson\davidje01,SF,23,38,2,322,51,125,0.408,0,0,,51,125,0.408,0.408,18,28,0.643,21,41,62,13,7,15,17,46,120
Baron Davis\davisba01,PG,28,82,82,3196,650,1526,0.426,173,525,0.33,477,1001,0.477,0.483,318,424,0.75,96,289,385,623,191,43,232,247,1791
Glen Davis\davisgl01,C,22,69,1,940,107,221,0.484,0,0,,107,221,0.484,0.484,99,150,0.66,95,113,208,28,31,20,65,160,313
Paul Davis\davispa01,PF,23,22,1,194,24,65,0.369,0,0,,24,65,0.369,0.369,6,10,0.6,25,22,47,10,6,6,9,33,54
Ricky Davis\davisri01,SF,28,82,47,2963,420,971,0.433,135,333,0.405,285,638,0.447,0.502,155,197,0.787,55,298,353,276,87,14,191,187,1130
Carlos Delfino\delfica01,SG,25,82,0,1928,251,632,0.397,120,314,0.382,131,318,0.412,0.492,116,156,0.744,66,293,359,145,69,11,75,177,738
Luol Deng\denglu01,SF,22,63,59,2128,429,896,0.479,8,22,0.364,421,874,0.482,0.483,204,265,0.77,136,258,394,155,57,29,120,117,1070
Boris Diaw\diawbo01,PF,25,82,19,2308,308,646,0.477,13,41,0.317,295,605,0.488,0.487,96,129,0.744,97,281,378,317,61,39,155,166,725
Yakhouba Diawara\diawaya01,SG,25,54,14,542,55,134,0.41,21,66,0.318,34,68,0.5,0.489,22,31,0.71,23,39,62,37,8,3,16,61,153
Guillermo Diaz\diazgu01,SG,22,6,0,18,1,4,0.25,0,1,0,1,3,0.333,0.25,3,5,0.6,2,0,2,1,0,0,0,0,5
Dan Dickau\dickada01,PG,29,67,8,1040,124,296,0.419,36,108,0.333,88,188,0.468,0.48,68,82,0.829,13,84,97,172,32,3,55,108,352
Kaniel Dickens\dickeka01,PF,29,5,0,12,1,3,0.333,0,0,,1,3,0.333,0.333,0,0,,0,1,1,1,0,1,0,1,2
Travis Diener\dienetr01,PG,25,66,21,1356,159,430,0.37,74,233,0.318,85,197,0.431,0.456,64,71,0.901,26,89,115,251,35,4,55,107,456
Ike Diogu\dioguik01,PF,24,30,1,305,64,134,0.478,0,0,,64,134,0.478,0.478,40,47,0.851,38,47,85,10,7,3,20,43,168
DeSagana Diop\diopde01,C,26,79,23,1295,94,180,0.522,0,0,,94,180,0.522,0.522,38,70,0.543,160,232,392,40,26,88,58,146,226
DeSagana Diop\diopde01,C,26,52,18,894,67,115,0.583,0,0,,67,115,0.583,0.583,24,40,0.6,111,159,270,26,20,63,42,100,158
DeSagana Diop\diopde01,C,26,27,5,401,27,65,0.415,0,0,,27,65,0.415,0.415,14,30,0.467,49,73,122,14,6,25,16,46,68
Juan Dixon\dixonju01,PG,29,53,0,668,106,258,0.411,30,72,0.417,76,186,0.409,0.469,21,26,0.808,15,60,75,97,21,2,54,62,263
Juan Dixon\dixonju01,PG,29,36,0,424,59,160,0.369,17,39,0.436,42,121,0.347,0.422,18,19,0.947,9,38,47,65,21,2,35,38,153
Juan Dixon\dixonju01,PG,29,17,0,244,47,98,0.48,13,33,0.394,34,65,0.523,0.546,3,7,0.429,6,22,28,32,0,0,19,24,110
Michael Doleac\doleami01,C,30,24,8,257,28,63,0.444,0,0,,28,63,0.444,0.444,1,2,0.5,16,33,49,7,10,10,12,44,57
Keyon Dooling\doolike01,PG,27,72,1,1334,198,423,0.468,22,65,0.338,176,358,0.492,0.494,163,193,0.845,7,94,101,133,36,5,61,131,581
Quincy Douby\doubyqu01,PG,23,74,0,876,132,335,0.394,42,122,0.344,90,213,0.423,0.457,48,52,0.923,17,66,83,53,30,12,59,80,354
Jared Dudley\dudleja01,PF,22,73,14,1384,163,348,0.468,9,41,0.22,154,307,0.502,0.481,87,118,0.737,121,165,286,81,55,10,50,128,422
Chris Duhon\duhonch01,PG,25,66,18,1490,133,344,0.387,54,155,0.348,79,189,0.418,0.465,65,80,0.813,19,97,116,263,48,2,71,92,385
Tim Duncan\duncati01,C,31,78,78,2651,585,1178,0.497,0,4,0,585,1174,0.498,0.497,338,463,0.73,237,644,881,218,56,152,178,185,1508
Mike Dunleavy\dunlemi02,SG,27,82,82,2953,532,1117,0.476,165,389,0.424,367,728,0.504,0.55,336,403,0.834,59,365,424,288,86,31,190,208,1565
Ronald Dupree\duprero01,SF,27,5,0,21,1,3,0.333,0,0,,1,3,0.333,0.333,2,2,1,1,7,8,1,1,0,0,0,4
Ronald Dupree\duprero01,SF,27,1,0,3,0,0,,0,0,,0,0,,,0,0,,0,0,0,0,0,0,0,0,0
Ronald Dupree\duprero01,SF,27,4,0,18,1,3,0.333,0,0,,1,3,0.333,0.333,2,2,1,1,7,8,1,1,0,0,0,4
Kevin Durant\duranke01,SG,19,80,80,2768,587,1366,0.43,59,205,0.288,528,1161,0.455,0.451,391,448,0.873,70,278,348,192,78,75,232,122,1624
Monta Ellis\ellismo01,SG,22,81,72,3071,652,1227,0.531,12,52,0.231,640,1175,0.545,0.536,320,417,0.767,133,271,404,315,124,27,173,195,1636
Francisco Elson\elsonfr01,C,31,63,5,813,92,236,0.39,0,1,0,92,235,0.391,0.39,26,37,0.703,50,150,200,24,15,20,47,96,210
Francisco Elson\elsonfr01,C,31,41,3,534,62,148,0.419,0,0,,62,148,0.419,0.419,20,24,0.833,33,102,135,16,9,14,30,62,144
Francisco Elson\elsonfr01,C,31,22,2,279,30,88,0.341,0,1,0,30,87,0.345,0.341,6,13,0.462,17,48,65,8,6,6,17,34,66
Melvin Ely\elyme01,C,29,52,1,621,85,180,0.472,0,0,,85,180,0.472,0.472,32,58,0.552,28,117,145,22,7,18,42,79,202
Maurice Evans\evansma01,SG,29,75,47,1720,262,545,0.481,81,209,0.388,181,336,0.539,0.555,59,83,0.711,92,126,218,81,46,10,40,142,664
Maurice Evans\evansma01,SG,29,7,0,96,9,28,0.321,1,7,0.143,8,21,0.381,0.339,12,15,0.8,4,5,9,12,5,1,0,10,31
Maurice Evans\evansma01,SG,29,68,47,1624,253,517,0.489,80,202,0.396,173,315,0.549,0.567,47,68,0.691,88,121,209,69,41,9,40,132,633
Reggie Evans\evansre01,PF,27,81,61,1879,152,346,0.439,1,1,1,151,345,0.438,0.441,120,257,0.467,224,387,611,65,86,8,108,213,425
Jordan Farmar\farmajo01,PG,21,82,0,1690,291,631,0.461,114,307,0.371,177,324,0.546,0.552,53,78,0.679,39,144,183,225,77,5,108,105,749
Nick Fazekas\fazekni01,PF,22,26,0,269,46,82,0.561,0,2,0,46,80,0.575,0.561,15,22,0.682,34,55,89,11,8,11,13,25,107
Nick Fazekas\fazekni01,PF,22,4,0,9,2,5,0.4,0,0,,2,5,0.4,0.4,0,0,,1,2,3,0,0,0,0,0,4
Nick Fazekas\fazekni01,PF,22,22,0,260,44,77,0.571,0,2,0,44,75,0.587,0.571,15,22,0.682,33,53,86,11,8,11,13,25,103
Raymond Felton\feltora01,PG,23,79,79,2972,412,997,0.413,56,200,0.28,356,797,0.447,0.441,260,325,0.8,37,199,236,583,96,12,213,184,1140
Kyrylo Fesenko\fesenky01,C,21,9,0,70,6,16,0.375,0,0,,6,16,0.375,0.375,2,4,0.5,14,11,25,2,0,3,8,19,14
Michael Finley\finlemi01,SG,34,82,61,2204,315,761,0.414,132,357,0.37,183,404,0.453,0.501,64,80,0.8,27,227,254,114,29,10,56,93,826
Derek Fisher\fishede01,PG,33,82,82,2249,339,777,0.436,112,276,0.406,227,501,0.453,0.508,166,188,0.883,24,146,170,239,86,3,90,188,956
T.J. Ford\fordtj01,PG,24,51,26,1199,246,524,0.469,15,51,0.294,231,473,0.488,0.484,110,125,0.88,23,77,100,313,54,0,102,93,617
Jeff Foster\fosteje01,C,31,77,52,1884,205,373,0.55,0,3,0,205,370,0.554,0.55,86,145,0.593,264,404,668,129,56,32,62,221,496
Randy Foye\foyera01,PG,24,39,31,1259,198,462,0.429,61,148,0.412,137,314,0.436,0.495,53,65,0.815,13,115,128,164,36,3,79,102,510
Adonal Foyle\foylead01,C,32,82,0,774,70,153,0.458,0,0,,70,153,0.458,0.458,16,34,0.471,71,137,208,18,16,45,32,94,156
Richie Frahm\frahmri01,SG,30,10,2,163,20,54,0.37,7,25,0.28,13,29,0.448,0.435,0,2,0,4,10,14,8,2,0,6,7,47
Steve Francis\francst01,PG,30,10,3,199,19,57,0.333,4,17,0.235,15,40,0.375,0.368,13,23,0.565,8,15,23,30,9,5,14,25,55
Channing Frye\fryech01,C,24,78,20,1342,221,453,0.488,3,10,0.3,218,443,0.492,0.491,85,109,0.78,107,247,354,57,29,27,55,208,530
Dan Gadzuric\gadzuda01,C,29,51,4,534,64,154,0.416,0,1,0,64,153,0.418,0.416,33,63,0.524,67,77,144,11,20,24,34,83,161
Jorge Garbajosa\garbajo01,PF,30,7,0,74,8,25,0.32,6,16,0.375,2,9,0.222,0.44,0,0,,2,13,15,3,3,0,1,2,22
Francisco Garcia\garcifr01,SF,26,79,20,2096,348,752,0.463,113,289,0.391,235,463,0.508,0.538,162,208,0.779,52,212,264,128,96,50,128,232,971
Thomas Gardner\gardnth01,SG,22,4,0,45,9,23,0.391,3,12,0.25,6,11,0.545,0.457,0,2,0,3,1,4,1,0,0,4,4,21
Kevin Garnett\garneke01,PF,31,71,71,2328,534,990,0.539,0,11,0,534,979,0.545,0.539,269,336,0.801,135,520,655,244,100,89,138,163,1337
Pat Garrity\garripa01,PF,31,31,0,284,27,80,0.338,8,37,0.216,19,43,0.442,0.388,4,5,0.8,9,35,44,13,6,1,17,35,66
Pau Gasol\gasolpa01,C,27,66,66,2351,475,890,0.534,4,16,0.25,471,874,0.539,0.536,292,362,0.807,155,398,553,211,30,98,124,139,1246
Pau Gasol\gasolpa01,C,27,39,39,1433,279,557,0.501,4,15,0.267,275,542,0.507,0.504,176,215,0.819,94,248,342,116,16,56,80,85,738
Pau Gasol\gasolpa01,C,27,27,27,918,196,333,0.589,0,1,0,196,332,0.59,0.589,116,147,0.789,61,150,211,95,14,42,44,54,508
Rudy Gay\gayru01,SF,21,81,81,3000,625,1355,0.461,134,387,0.346,491,968,0.507,0.511,248,316,0.785,140,359,499,158,111,79,190,230,1632
Mickael Gelabale\gelabmi01,SG,24,39,0,465,69,157,0.439,16,37,0.432,53,120,0.442,0.49,14,18,0.778,16,42,58,33,10,9,27,31,168
Devean George\georgde01,SF,30,53,4,821,74,207,0.357,22,68,0.324,52,139,0.374,0.411,24,34,0.706,28,109,137,35,19,13,24,90,194
Daniel Gibson\gibsoda01,PG,21,58,26,1765,201,465,0.432,118,268,0.44,83,197,0.421,0.559,85,105,0.81,30,104,134,145,47,14,76,163,605
Eddie Gill\gilled01,PG,29,14,1,154,12,31,0.387,5,15,0.333,7,16,0.438,0.468,9,9,1,1,21,22,22,7,2,9,18,38
Eddie Gill\gilled01,PG,29,13,1,149,12,29,0.414,5,14,0.357,7,15,0.467,0.5,9,9,1,1,21,22,21,7,2,8,18,38
Eddie Gill\gilled01,PG,29,1,0,5,0,2,0,0,1,0,0,1,0,0,0,0,,0,0,0,1,0,0,1,0,0
Manu Ginobili\ginobma01,SG,30,74,23,2299,453,984,0.46,156,389,0.401,297,595,0.499,0.54,380,442,0.86,63,291,354,332,109,33,200,173,1442
Gordan Giricek\giricgo01,SG,30,56,0,831,133,302,0.44,36,99,0.364,97,203,0.478,0.5,23,26,0.885,16,80,96,62,24,4,52,82,325
Gordan Giricek\giricgo01,SG,30,22,0,279,41,102,0.402,12,34,0.353,29,68,0.426,0.461,1,1,1,6,25,31,16,13,1,21,24,95
Gordan Giricek\giricgo01,SG,30,12,0,110,13,41,0.317,5,15,0.333,8,26,0.308,0.378,6,8,0.75,1,13,14,11,3,1,8,9,37
Gordan Giricek\giricgo01,SG,30,22,0,442,79,159,0.497,19,50,0.38,60,109,0.55,0.557,16,17,0.941,9,42,51,35,8,2,23,49,193
Ryan Gomes\gomesry01,PF,25,82,74,2434,392,857,0.457,59,179,0.33,333,678,0.491,0.492,190,229,0.83,133,342,475,145,65,10,96,154,1033
Drew Gooden\goodedr01,PF,26,69,65,2122,332,740,0.449,0,6,0,332,734,0.452,0.449,162,215,0.753,175,415,590,81,48,53,122,203,826
Drew Gooden\goodedr01,PF,26,51,51,1564,232,523,0.444,0,3,0,232,520,0.446,0.444,110,151,0.728,117,306,423,50,35,30,91,144,574
Drew Gooden\goodedr01,PF,26,18,14,558,100,217,0.461,0,3,0,100,214,0.467,0.461,52,64,0.813,58,109,167,31,13,23,31,59,252
Ben Gordon\gordobe01,SG,24,72,27,2291,464,1069,0.434,142,346,0.41,322,723,0.445,0.5,266,293,0.908,40,181,221,213,55,8,150,171,1336
Marcin Gortat\gortama01,C,23,6,0,41,8,17,0.471,0,0,,8,17,0.471,0.471,2,3,0.667,8,8,16,2,1,1,2,4,18
Joey Graham\grahajo01,SF,25,38,3,331,49,113,0.434,2,3,0.667,47,110,0.427,0.442,38,45,0.844,18,49,67,15,3,0,23,47,138
Stephen Graham\grahast01,SF,25,22,0,128,34,58,0.586,7,14,0.5,27,44,0.614,0.647,12,16,0.75,4,18,22,9,4,1,10,14,87
Danny Granger\grangda01,SF,24,80,80,2876,537,1205,0.446,171,423,0.404,366,782,0.468,0.517,322,378,0.852,93,393,486,166,95,84,171,290,1567
Aaron Gray\grayaa01,C,23,61,1,613,103,204,0.505,0,1,0,103,203,0.507,0.505,56,99,0.566,70,98,168,41,21,16,57,117,262
Gerald Green\greenge01,SF,22,30,0,362,52,151,0.344,15,39,0.385,37,112,0.33,0.394,34,41,0.829,13,51,64,29,8,4,32,45,153
Gerald Green\greenge01,SF,22,29,0,358,49,148,0.331,15,39,0.385,34,109,0.312,0.382,34,41,0.829,11,51,62,29,8,4,32,43,147
Gerald Green\greenge01,SF,22,1,0,4,3,3,1,0,0,,3,3,1,1,0,0,,2,0,2,0,0,0,0,2,6
Jeff Green\greenje02,SF,21,80,52,2253,320,749,0.427,21,76,0.276,299,673,0.444,0.441,177,238,0.744,101,278,379,119,46,49,158,198,838
Taurean Green\greenta01,SG-PG,21,17,0,74,7,25,0.28,2,11,0.182,5,14,0.357,0.32,11,12,0.917,0,10,10,11,2,0,9,5,27
Taurean Green\greenta01,PG,21,8,0,44,4,16,0.25,1,8,0.125,3,8,0.375,0.281,8,8,1,0,4,4,8,1,0,7,3,17
Taurean Green\greenta01,SG,21,9,0,30,3,9,0.333,1,3,0.333,2,6,0.333,0.389,3,4,0.75,0,6,6,3,1,0,2,2,10
Willie Green\greenwi01,SG,26,74,74,1970,379,870,0.436,51,179,0.285,328,691,0.475,0.465,112,148,0.757,32,150,182,151,54,22,109,119,921
Orien Greene\greenor01,SG,25,7,2,61,3,11,0.273,0,1,0,3,10,0.3,0.273,0,0,,0,6,6,3,3,1,7,9,6
Adrian Griffin\griffad01,SG-SF,33,35,2,307,30,76,0.395,0,0,,30,76,0.395,0.395,5,9,0.556,28,31,59,27,17,2,21,27,65
Adrian Griffin\griffad01,SG,33,22,2,222,24,60,0.4,0,0,,24,60,0.4,0.4,3,7,0.429,19,18,37,22,12,1,16,19,51
Adrian Griffin\griffad01,SF,33,13,0,85,6,16,0.375,0,0,,6,16,0.375,0.375,2,2,1,9,13,22,5,5,1,5,8,14
Richard Hamilton\hamilri01,SG,29,72,72,2424,499,1030,0.484,62,141,0.44,437,889,0.492,0.515,184,221,0.833,75,160,235,299,73,10,132,171,1244
Anfernee Hardaway\hardaan01,SF,36,16,8,325,22,60,0.367,8,19,0.421,14,41,0.341,0.433,8,9,0.889,3,32,35,35,19,1,13,24,60
Matt Harpring\harprma01,SF,31,76,0,1374,237,474,0.5,2,10,0.2,235,464,0.506,0.502,146,205,0.712,96,144,240,82,45,14,95,162,622
Al Harrington\harrial01,C,27,81,59,2190,401,923,0.434,153,408,0.375,248,515,0.482,0.517,147,190,0.774,107,332,439,132,74,16,90,266,1102
Othella Harrington\harriot01,C,34,22,0,166,18,42,0.429,0,0,,18,42,0.429,0.429,10,16,0.625,11,31,42,4,1,4,11,34,46
Devin Harris\harride01,PG,24,64,61,2022,321,693,0.463,56,167,0.335,265,526,0.504,0.504,248,301,0.824,28,145,173,369,90,10,161,190,946
Devin Harris\harride01,PG,24,39,39,1184,187,387,0.483,25,70,0.357,162,317,0.511,0.516,161,196,0.821,17,74,91,206,56,2,93,127,560
Devin Harris\harride01,PG,24,25,22,838,134,306,0.438,31,97,0.32,103,209,0.493,0.489,87,105,0.829,11,71,82,163,34,8,68,63,386
Mike Harris\harrimi01,PF,24,17,0,159,27,54,0.5,0,2,0,27,52,0.519,0.5,8,13,0.615,24,30,54,3,6,3,9,16,62
David Harrison\harrida01,C,25,55,0,702,90,170,0.529,0,0,,90,170,0.529,0.529,49,96,0.51,43,75,118,14,20,59,58,164,229
Jason Hart\hartja01,PG,29,57,0,606,58,180,0.322,11,31,0.355,47,149,0.315,0.353,38,45,0.844,5,50,55,86,30,3,28,75,165
Udonis Haslem\hasleud01,PF,27,49,48,1805,237,507,0.467,0,0,,237,507,0.467,0.467,115,142,0.81,107,336,443,68,39,18,67,145,589
Trenton Hassell\hassetr01,SG,28,63,6,773,57,135,0.422,2,9,0.222,55,126,0.437,0.43,7,10,0.7,20,63,83,41,13,3,22,90,123
Trenton Hassell\hassetr01,SG,28,37,6,463,37,80,0.463,1,4,0.25,36,76,0.474,0.469,1,2,0.5,11,33,44,26,9,1,14,55,76
Trenton Hassell\hassetr01,SG,28,26,0,310,20,55,0.364,1,5,0.2,19,50,0.38,0.373,6,8,0.75,9,30,39,15,4,2,8,35,47
Spencer Hawes\hawessp01,C,19,71,8,931,146,318,0.459,4,21,0.19,142,297,0.478,0.465,38,58,0.655,68,162,230,44,14,40,56,128,334
Chuck Hayes\hayesch01,PF,24,79,44,1575,113,221,0.511,0,3,0,113,218,0.518,0.511,11,24,0.458,132,295,427,91,85,43,62,212,237
Jarvis Hayes\hayesja01,SF,26,82,1,1287,217,504,0.431,73,194,0.376,144,310,0.465,0.503,45,60,0.75,35,143,178,62,47,6,47,137,552
Brendan Haywood\haywobr01,C,28,80,80,2228,316,599,0.528,0,0,,316,599,0.528,0.528,216,294,0.735,273,303,576,71,31,133,108,216,848
Luther Head\headlu01,SG,25,73,17,1379,206,477,0.432,79,225,0.351,127,252,0.504,0.515,66,81,0.815,18,117,135,138,44,9,70,75,557
Walter Herrmann\herrmwa01,PF,28,45,0,373,56,144,0.389,20,64,0.313,36,80,0.45,0.458,21,25,0.84,22,51,73,18,7,1,12,24,153
Walter Herrmann\herrmwa01,PF,28,17,0,174,25,65,0.385,9,26,0.346,16,39,0.41,0.454,9,10,0.9,10,26,36,4,4,0,4,12,68
Walter Herrmann\herrmwa01,PF,28,28,0,199,31,79,0.392,11,38,0.289,20,41,0.488,0.462,12,15,0.8,12,25,37,14,3,1,8,12,85
Nene Hilario\hilarne01,PF,25,16,1,266,29,71,0.408,0,1,0,29,70,0.414,0.408,27,49,0.551,30,57,87,15,9,14,21,46,85
Grant Hill*\hillgr01,SF,35,70,68,2222,358,712,0.503,33,104,0.317,325,608,0.535,0.526,170,196,0.867,74,279,353,203,65,56,96,153,919
Kirk Hinrich\hinriki01,PG,27,75,72,2380,330,797,0.414,84,240,0.35,246,557,0.442,0.467,118,142,0.831,28,216,244,452,87,19,157,224,862
Ryan Hollins\holliry01,PF,23,60,1,532,46,94,0.489,0,0,,46,94,0.489,0.489,55,82,0.671,53,54,107,14,10,30,25,96,147
Al Horford\horfoal01,C,21,81,77,2540,333,668,0.499,0,5,0,333,663,0.502,0.499,155,212,0.731,248,537,785,124,60,76,137,267,821
Robert Horry\horryro01,PF,37,45,5,583,38,119,0.319,18,70,0.257,20,49,0.408,0.395,18,28,0.643,35,74,109,47,21,19,22,55,112
Eddie House\houseed01,PG,29,78,2,1480,217,531,0.409,117,298,0.393,100,233,0.429,0.519,33,36,0.917,19,148,167,152,59,10,76,114,584
Dwight Howard\howardw01,C,22,82,82,3088,583,974,0.599,0,4,0,583,970,0.601,0.599,529,897,0.59,279,882,1161,110,74,176,263,274,1695
Josh Howard\howarjo01,SF,27,76,76,2757,567,1247,0.455,67,210,0.319,500,1037,0.482,0.482,312,384,0.813,120,412,532,164,59,32,114,202,1513
Juwan Howard\howarju01,PF,34,50,0,353,23,64,0.359,0,0,,23,64,0.359,0.359,11,14,0.786,21,60,81,17,5,2,17,62,57
Troy Hudson\hudsotr01,PG,31,9,0,93,9,31,0.29,4,12,0.333,5,19,0.263,0.355,6,6,1,0,7,7,9,3,0,7,4,28
Larry Hughes\hughela01,PG-SG,29,68,57,2020,305,801,0.381,67,194,0.345,238,607,0.392,0.423,150,188,0.798,39,191,230,181,99,17,116,139,827
Larry Hughes\hughela01,PG,29,40,32,1210,180,478,0.377,43,126,0.341,137,352,0.389,0.422,88,108,0.815,27,116,143,94,60,11,72,91,491
Larry Hughes\hughela01,SG,29,28,25,810,125,323,0.387,24,68,0.353,101,255,0.396,0.424,62,80,0.775,12,75,87,87,39,6,44,48,336
Kris Humphries\humphkr01,PF,22,70,0,925,161,333,0.483,0,2,0,161,331,0.486,0.483,75,124,0.605,90,169,259,28,25,28,47,107,397
Lindsey Hunter\hunteli01,PG,37,24,0,215,22,64,0.344,7,26,0.269,15,38,0.395,0.398,7,9,0.778,4,9,13,33,13,2,13,30,58
Steven Hunter\huntest01,C,26,19,2,120,15,28,0.536,0,0,,15,28,0.536,0.536,9,20,0.45,10,19,29,0,0,6,7,20,39
Andre Iguodala\iguodan01,SF,24,82,82,3242,582,1277,0.456,101,307,0.329,481,970,0.496,0.495,365,506,0.721,85,361,446,391,171,49,214,187,1630
Zydrunas Ilgauskas\ilgauzy01,C,32,73,73,2222,417,879,0.474,0,1,0,417,878,0.475,0.474,195,243,0.802,263,419,682,104,34,120,135,247,1029
Didier Ilunga-Mbenga\mbengdj01,C,27,42,0,326,39,84,0.464,0,0,,39,84,0.464,0.464,5,12,0.417,28,44,72,10,7,26,12,70,83
Didier Ilunga-Mbenga\mbengdj01,C,27,16,0,130,9,23,0.391,0,0,,9,23,0.391,0.391,1,2,0.5,13,18,31,4,3,10,4,32,19
Didier Ilunga-Mbenga\mbengdj01,C,27,26,0,196,30,61,0.492,0,0,,30,61,0.492,0.492,4,10,0.4,15,26,41,6,4,16,8,38,64
Allen Iverson*\iversal01,SG,32,82,82,3424,712,1556,0.458,95,275,0.345,617,1281,0.482,0.488,645,797,0.809,47,196,243,586,160,12,245,109,2164
Royal Ivey\iveyro01,PG,26,75,20,1437,149,378,0.394,35,107,0.327,114,271,0.421,0.44,85,117,0.726,38,80,118,160,45,7,75,166,418
Jarrett Jack\jackja01,SG,24,82,16,2229,267,620,0.431,65,190,0.342,202,430,0.47,0.483,215,248,0.867,31,203,234,313,61,1,178,129,814
Bobby Jackson\jacksbo01,SG-PG,34,72,5,1389,204,506,0.403,81,226,0.358,123,280,0.439,0.483,64,81,0.79,33,148,181,139,45,5,59,96,553
Bobby Jackson\jacksbo01,SG,34,46,0,891,116,296,0.392,53,144,0.368,63,152,0.414,0.481,40,49,0.816,23,87,110,76,32,3,31,59,325
Bobby Jackson\jacksbo01,PG,34,26,5,498,88,210,0.419,28,82,0.341,60,128,0.469,0.486,24,32,0.75,10,61,71,63,13,2,28,37,228
Luke Jackson\jackslu02,SF,26,14,1,228,26,80,0.325,11,30,0.367,15,50,0.3,0.394,16,23,0.696,7,26,33,17,8,0,9,22,79
Stephen Jackson\jacksst02,SF,29,73,73,2855,488,1204,0.405,182,501,0.363,306,703,0.435,0.481,308,370,0.832,67,251,318,300,92,29,197,171,1466
Casey Jacobsen\jacobca01,SG,26,53,0,547,39,115,0.339,16,72,0.222,23,43,0.535,0.409,13,17,0.765,12,53,65,20,5,1,16,34,107
Jerome James\jamesje01,C,32,2,0,5,1,1,1,0,0,,1,1,1,1,2,2,1,0,3,3,0,0,0,0,0,4
LeBron James\jamesle01,SF,23,75,74,3027,794,1642,0.484,113,359,0.315,681,1283,0.531,0.518,549,771,0.712,133,459,592,539,138,81,255,165,2250
Mike James\jamesmi01,PG,32,54,1,720,101,290,0.348,31,97,0.32,70,193,0.363,0.402,39,48,0.813,14,55,69,60,21,2,36,56,272
Mike James\jamesmi01,PG,32,33,1,537,79,226,0.35,24,74,0.324,55,152,0.362,0.403,33,42,0.786,11,41,52,54,17,2,29,44,215
Mike James\jamesmi01,PG,32,21,0,183,22,64,0.344,7,23,0.304,15,41,0.366,0.398,6,6,1,3,14,17,6,4,0,7,12,57
Antawn Jamison\jamisan01,PF,31,79,79,3061,618,1417,0.436,120,354,0.339,498,1063,0.468,0.478,333,438,0.76,215,591,806,120,106,34,113,195,1689
Marko Jaric\jaricma01,SG,29,75,56,2189,227,528,0.43,46,127,0.362,181,401,0.451,0.473,121,163,0.742,38,184,222,311,97,32,128,180,621
Al Jefferson\jeffeal01,C,23,82,82,2919,721,1441,0.5,0,5,0,721,1436,0.502,0.5,284,394,0.721,308,603,911,117,74,119,167,222,1726
Richard Jefferson\jefferi01,SF,27,82,82,3200,619,1328,0.466,77,213,0.362,542,1115,0.486,0.495,542,679,0.798,93,249,342,252,76,21,199,225,1857
Jared Jeffries\jeffrja01,SF,26,73,19,1325,108,270,0.4,4,25,0.16,104,245,0.424,0.407,49,93,0.527,118,125,243,66,36,23,64,132,269
Yi Jianlian\jianlyi01,PF,20,66,49,1647,219,520,0.421,6,21,0.286,213,499,0.427,0.427,122,145,0.841,106,238,344,55,36,56,90,153,566
Alexander Johnson\johnsal01,PF,24,43,6,549,61,125,0.488,0,0,,61,125,0.488,0.488,57,83,0.687,32,62,94,13,13,10,42,80,179
Amir Johnson\johnsam01,PF,20,62,0,764,92,165,0.558,0,0,,92,165,0.558,0.558,37,55,0.673,87,148,235,29,24,82,39,141,221
Anthony Johnson\johnsan02,PG,33,69,52,1531,155,355,0.437,42,93,0.452,113,262,0.431,0.496,35,43,0.814,22,115,137,262,52,9,84,115,387
Anthony Johnson\johnsan02,PG,33,42,41,1121,115,267,0.431,27,63,0.429,88,204,0.431,0.481,26,32,0.813,17,81,98,202,42,8,50,86,283
Anthony Johnson\johnsan02,PG,33,27,11,410,40,88,0.455,15,30,0.5,25,58,0.431,0.54,9,11,0.818,5,34,39,60,10,1,34,29,104
DerMarr Johnson\johnsde03,SF,27,5,0,28,7,14,0.5,3,9,0.333,4,5,0.8,0.607,0,2,0,0,1,1,1,1,0,0,4,17
Joe Johnson\johnsjo02,SG,26,82,82,3343,647,1497,0.432,169,444,0.381,478,1053,0.454,0.489,316,379,0.834,83,284,367,474,84,18,223,168,1779
Linton Johnson\johnsli01,PF,27,8,0,63,9,19,0.474,1,3,0.333,8,16,0.5,0.5,2,2,1,5,9,14,4,0,1,5,11,21
Linton Johnson\johnsli01,PF,27,6,0,53,7,14,0.5,1,2,0.5,6,12,0.5,0.536,0,0,,5,8,13,3,0,1,2,10,15
Linton Johnson\johnsli01,PF,27,2,0,10,2,5,0.4,0,1,0,2,4,0.5,0.4,2,2,1,0,1,1,1,0,0,3,1,6
Bobby Jones\jonesbo02,C-SF,24,47,2,531,60,140,0.429,18,53,0.34,42,87,0.483,0.493,40,51,0.784,29,63,92,28,15,3,28,85,178
Bobby Jones\jonesbo02,C,24,25,0,222,26,64,0.406,9,23,0.391,17,41,0.415,0.477,23,28,0.821,11,27,38,11,5,1,14,46,84
Bobby Jones\jonesbo02,SF,24,9,2,137,14,36,0.389,3,13,0.231,11,23,0.478,0.431,9,10,0.9,10,17,27,11,5,2,5,17,40
Bobby Jones\jonesbo02,SF,24,4,0,9,2,4,0.5,0,0,,2,4,0.5,0.5,0,0,,0,1,1,0,1,0,1,3,4
Bobby Jones\jonesbo02,SF,24,6,0,143,17,32,0.531,6,15,0.4,11,17,0.647,0.625,8,13,0.615,8,16,24,5,2,0,7,18,48
Bobby Jones\jonesbo02,SF,24,3,0,20,1,4,0.25,0,2,0,1,2,0.5,0.25,0,0,,0,2,2,1,2,0,1,1,2
Dahntay Jones\jonesda02,SG,27,25,0,206,23,53,0.434,1,6,0.167,22,47,0.468,0.443,34,51,0.667,7,28,35,12,8,6,10,28,81
Damon Jones\jonesda01,SG,31,67,3,1336,151,363,0.416,115,276,0.417,36,87,0.414,0.574,20,28,0.714,5,67,72,126,19,1,36,66,437
Dwayne Jones\jonesdw02,PF,24,56,0,472,25,47,0.532,0,1,0,25,46,0.543,0.532,28,58,0.483,69,71,140,10,10,25,17,88,78
Eddie Jones\jonesed02,SG,36,47,33,922,66,180,0.367,34,116,0.293,32,64,0.5,0.461,10,14,0.714,18,114,132,69,26,8,29,72,176
Fred Jones\jonesfr01,SG,28,70,26,1757,182,432,0.421,74,192,0.385,108,240,0.45,0.507,94,126,0.746,30,140,170,166,48,18,78,140,532
James Jones\jonesja02,SF,27,58,3,1276,143,327,0.437,91,205,0.444,52,122,0.426,0.576,86,98,0.878,43,118,161,34,24,15,28,96,463
Solomon Jones\jonesso01,PF,23,35,0,145,12,30,0.4,0,2,0,12,28,0.429,0.4,11,20,0.55,19,23,42,0,3,5,11,28,35
Chris Kaman\kamanch01,C,25,56,55,2083,338,700,0.483,0,4,0,338,696,0.486,0.483,202,265,0.762,173,538,711,107,33,155,164,179,878
Jason Kapono\kaponja01,SF,26,81,7,1530,243,498,0.488,57,118,0.483,186,380,0.489,0.545,37,43,0.86,31,89,120,65,34,2,58,131,580
Coby Karl\karlco01,SG,24,17,0,71,9,26,0.346,4,13,0.308,5,13,0.385,0.423,8,10,0.8,3,11,14,9,4,2,5,4,30
Viktor Khryapa\khryavi01,PF,25,9,0,105,12,31,0.387,0,1,0,12,30,0.4,0.387,8,14,0.571,6,14,20,8,6,0,6,11,32
Jason Kidd*\kiddja01,PG,34,80,80,2906,305,793,0.385,119,312,0.381,186,481,0.387,0.46,135,165,0.818,94,506,600,806,136,26,266,165,864
Jason Kidd*\kiddja01,PG,34,51,51,1895,201,549,0.366,84,236,0.356,117,313,0.374,0.443,91,111,0.82,58,354,412,530,74,15,185,90,577
Jason Kidd*\kiddja01,PG,34,29,29,1011,104,244,0.426,35,76,0.461,69,168,0.411,0.498,44,54,0.815,36,152,188,276,62,11,81,75,287
Tarence Kinsey\kinseta01,SG,23,11,0,96,16,38,0.421,3,7,0.429,13,31,0.419,0.461,5,6,0.833,3,9,12,2,3,0,3,11,40
Andrei Kirilenko\kirilan01,SF,26,72,72,2217,275,544,0.506,44,116,0.379,231,428,0.54,0.546,198,257,0.77,121,218,339,285,86,109,140,165,792
Linas Kleiza\kleizli01,SF,23,79,13,1889,311,659,0.472,94,277,0.339,217,382,0.568,0.543,164,213,0.77,92,241,333,95,44,19,89,181,880
Brevin Knight\knighbr01,PG,32,74,39,1674,138,342,0.404,0,6,0,138,336,0.411,0.404,62,71,0.873,15,127,142,328,100,11,71,160,338
Kyle Korver\korveky01,SG-PF,26,75,0,1732,255,575,0.443,111,296,0.375,144,279,0.516,0.54,119,130,0.915,21,151,172,101,42,29,75,192,740
Kyle Korver\korveky01,PF,26,25,0,657,90,227,0.396,38,108,0.352,52,119,0.437,0.48,31,34,0.912,12,61,73,33,20,6,28,67,249
Kyle Korver\korveky01,SG,26,50,0,1075,165,348,0.474,73,188,0.388,92,160,0.575,0.579,88,96,0.917,9,90,99,68,22,23,47,125,491
Nenad Krstic\krstine01,C,24,45,38,812,123,300,0.41,0,2,0,123,298,0.413,0.41,52,69,0.754,35,165,200,27,9,17,41,111,298
Raef LaFrentz\lafrera01,C,31,39,0,291,27,61,0.443,0,4,0,27,57,0.474,0.443,11,19,0.579,28,39,67,6,12,17,10,59,65
Carl Landry\landrca01,PF,24,42,0,711,135,219,0.616,0,1,0,135,218,0.619,0.616,72,109,0.661,96,111,207,21,17,7,26,98,342
Keith Langford\langfke01,SG,24,2,0,10,1,4,0.25,0,0,,1,4,0.25,0.25,0,0,,0,2,2,0,0,0,0,1,2
Stephane Lasme\lasmest01,PF-SF,25,16,4,303,32,71,0.451,0,0,,32,71,0.451,0.451,19,32,0.594,26,27,53,3,13,22,15,35,83
Stephane Lasme\lasmest01,SF,25,1,0,0,0,0,,0,0,,0,0,,,0,0,,0,0,0,0,0,0,0,0,0
Stephane Lasme\lasmest01,PF,25,15,4,303,32,71,0.451,0,0,,32,71,0.451,0.451,19,32,0.594,26,27,53,3,13,22,15,35,83
Acie Law\lawac01,PG,23,56,6,865,95,237,0.401,7,34,0.206,88,203,0.433,0.416,38,48,0.792,12,45,57,113,29,0,56,73,235
David Lee\leeda02,PF,24,81,29,2356,341,618,0.552,0,2,0,341,616,0.554,0.552,194,237,0.819,242,482,724,95,55,29,97,210,876
Rashard Lewis\lewisra02,PF,28,81,81,3076,516,1135,0.455,226,553,0.409,290,582,0.498,0.554,218,260,0.838,97,340,437,196,99,38,140,214,1476
Kyle Lowry\lowryky01,PG,21,82,9,2089,256,592,0.432,36,140,0.257,220,452,0.487,0.463,243,348,0.698,41,209,250,296,92,22,127,185,791
Tyronn Lue\luety01,PG,30,50,3,736,113,253,0.447,39,86,0.453,74,167,0.443,0.524,25,32,0.781,9,45,54,74,11,1,27,66,290
Tyronn Lue\luety01,PG,30,33,3,564,86,196,0.439,30,69,0.435,56,127,0.441,0.515,24,28,0.857,9,32,41,59,11,0,22,38,226
Tyronn Lue\luety01,PG,30,17,0,172,27,57,0.474,9,17,0.529,18,40,0.45,0.553,1,4,0.25,0,13,13,15,0,1,5,28,64
Mark Madsen\madsema01,PF,32,20,6,151,3,19,0.158,0,0,,3,19,0.158,0.158,3,12,0.25,18,20,38,4,3,2,9,25,9
Corey Maggette\maggeco01,SF,28,70,65,2502,458,1000,0.458,78,203,0.384,380,797,0.477,0.497,553,681,0.812,78,316,394,189,71,7,195,210,1547
Jamaal Magloire\magloja01,C,29,31,2,286,18,55,0.327,0,0,,18,55,0.327,0.327,20,44,0.455,19,70,89,7,1,10,30,50,56
Jamaal Magloire\magloja01,C,29,24,2,259,15,49,0.306,0,0,,15,49,0.306,0.306,14,31,0.452,18,63,81,7,0,10,23,42,44
Jamaal Magloire\magloja01,C,29,7,0,27,3,6,0.5,0,0,,3,6,0.5,0.5,6,13,0.462,1,7,8,0,1,0,7,8,12
Ian Mahinmi\mahinia01,C,21,6,0,23,6,12,0.5,0,0,,6,12,0.5,0.5,9,9,1,0,5,5,1,0,4,2,4,21
Stephon Marbury\marbust01,PG,30,24,19,805,111,265,0.419,28,74,0.378,83,191,0.435,0.472,83,116,0.716,17,42,59,113,21,2,48,57,333
Shawn Marion\mariosh01,PF,29,63,62,2315,400,787,0.508,66,198,0.333,334,589,0.567,0.55,106,150,0.707,136,507,643,138,125,85,86,150,972
Shawn Marion\mariosh01,PF,29,47,47,1713,304,578,0.526,58,167,0.347,246,411,0.599,0.576,77,108,0.713,86,378,464,98,95,70,49,117,743
Shawn Marion\mariosh01,PF,29,16,15,602,96,209,0.459,8,31,0.258,88,178,0.494,0.478,29,42,0.69,50,129,179,40,30,15,37,33,229
Sean Marks\marksse01,C,32,19,0,130,23,43,0.535,1,4,0.25,22,39,0.564,0.547,12,19,0.632,9,27,36,4,3,10,8,23,59
Donyell Marshall\marshdo01,PF,34,26,1,340,32,98,0.327,15,53,0.283,17,45,0.378,0.403,19,22,0.864,24,52,76,10,6,16,15,31,98
Donyell Marshall\marshdo01,PF,34,11,1,156,13,44,0.295,8,23,0.348,5,21,0.238,0.386,7,9,0.778,9,21,30,5,2,9,6,16,41
Donyell Marshall\marshdo01,PF,34,15,0,184,19,54,0.352,7,30,0.233,12,24,0.5,0.417,12,13,0.923,15,31,46,5,4,7,9,15,57
Darrick Martin\martida01,PG,36,17,0,141,10,43,0.233,2,16,0.125,8,27,0.296,0.256,5,6,0.833,3,4,7,21,6,0,1,12,27
Kenyon Martin\martike01,PF,30,71,71,2159,376,699,0.538,2,11,0.182,374,688,0.544,0.539,123,212,0.58,105,356,461,90,88,85,91,235,877
Kevin Martin\martike02,SG,24,61,57,2216,417,914,0.456,107,266,0.402,310,648,0.478,0.515,502,578,0.869,48,225,273,129,62,5,131,150,1443
Desmond Mason\masonde01,SF,30,59,56,1702,230,477,0.482,0,0,,230,477,0.482,0.482,114,173,0.659,75,181,256,121,40,30,83,106,574
Roger Mason\masonro01,PG,27,80,9,1708,266,600,0.443,130,327,0.398,136,273,0.498,0.552,62,71,0.873,17,113,130,134,40,18,69,140,724
Jason Maxiell\maxieja01,C,24,82,7,1768,240,446,0.538,0,1,0,240,445,0.539,0.538,171,270,0.633,177,256,433,46,21,94,71,183,651
Rashad McCants\mccanra01,SG,23,75,24,2020,428,944,0.453,142,349,0.407,286,595,0.481,0.529,116,155,0.748,50,156,206,162,66,18,172,234,1114
Jelani McCoy\mccoyje01,C,30,6,1,33,1,1,1,0,0,,1,1,1,1,1,2,0.5,1,6,7,0,0,5,4,7,3
Antonio McDyess\mcdyean01,PF,33,78,78,2285,293,600,0.488,0,2,0,293,598,0.49,0.488,97,156,0.622,204,462,666,89,61,53,75,246,683
Tracy McGrady*\mcgratr01,SG,28,66,62,2440,548,1307,0.419,86,295,0.292,462,1012,0.457,0.452,245,358,0.684,42,297,339,387,68,30,160,91,1427
Dominic McGuire\mcguido01,SG,22,70,1,695,39,103,0.379,1,6,0.167,38,97,0.392,0.383,14,32,0.438,53,86,139,40,20,26,40,76,93
Jeff McInnis\mcinnje01,PG,33,54,26,1410,108,249,0.434,3,19,0.158,105,230,0.457,0.44,23,30,0.767,16,80,96,220,23,3,76,120,242
Josh McRoberts\mcrobjo01,PF,20,8,0,28,6,10,0.6,0,1,0,6,9,0.667,0.6,0,0,,2,8,10,2,1,0,2,1,12
Chris Mihm\mihmch01,C,28,23,5,278,32,95,0.337,0,0,,32,95,0.337,0.337,18,27,0.667,28,49,77,13,4,14,17,42,82
C.J. Miles\milescj01,SG,20,60,13,689,113,236,0.479,30,77,0.39,83,159,0.522,0.542,41,52,0.788,16,62,78,53,32,8,27,98,297
Darko Milicic\milicda01,C,22,70,64,1663,219,500,0.438,0,1,0,219,499,0.439,0.438,67,121,0.554,127,297,424,58,32,114,101,185,505
Andre Miller\millean02,PG,31,82,82,3016,569,1156,0.492,3,34,0.088,566,1122,0.504,0.494,257,333,0.772,95,229,324,565,105,6,206,181,1398
Brad Miller\millebr01,C,31,72,72,2513,337,728,0.463,28,90,0.311,309,638,0.484,0.482,262,309,0.848,167,514,681,264,69,74,164,247,964
Mike Miller\millemi01,SG,27,70,70,2474,414,824,0.502,155,359,0.432,259,465,0.557,0.596,164,212,0.774,51,416,467,240,35,16,182,145,1147
Paul Millsap\millspa01,PF,22,82,2,1702,253,502,0.504,0,4,0,253,498,0.508,0.504,155,229,0.677,167,293,460,81,72,73,87,269,661
Yao Ming*\mingya01,C,27,55,55,2044,432,852,0.507,0,2,0,432,850,0.508,0.507,345,406,0.85,172,422,594,129,25,111,183,171,1209
Cuttino Mobley\moblecu01,SG,32,77,38,2702,377,870,0.433,67,192,0.349,310,678,0.457,0.472,163,199,0.819,50,225,275,202,78,34,123,152,984
Nazr Mohammed\mohamna01,C,30,82,29,1650,272,528,0.515,0,1,0,272,527,0.516,0.515,95,163,0.583,194,300,494,72,45,60,101,230,639
Nazr Mohammed\mohamna01,C,30,21,0,228,28,59,0.475,0,1,0,28,58,0.483,0.475,13,30,0.433,29,44,73,6,7,8,11,36,69
Nazr Mohammed\mohamna01,C,30,61,29,1422,244,469,0.52,0,0,,244,469,0.52,0.52,82,133,0.617,165,256,421,66,38,52,90,194,570
Jamario Moon\moonja01,SF,27,78,75,2166,279,575,0.485,40,122,0.328,239,453,0.528,0.52,63,85,0.741,92,392,484,90,80,108,51,152,661
Mikki Moore\mooremi01,PF,32,82,79,2385,282,489,0.577,0,2,0,282,487,0.579,0.577,134,182,0.736,160,334,494,84,35,46,110,310,698
Randolph Morris\morrira01,C,22,18,2,181,21,58,0.362,0,0,,21,58,0.362,0.362,14,29,0.483,12,25,37,2,4,2,9,37,56
Alonzo Mourning*\mournal01,C,37,25,0,389,52,95,0.547,0,0,,52,95,0.547,0.547,45,76,0.592,34,59,93,7,4,42,25,56,149
Troy Murphy\murphtr01,PF,27,75,61,2106,315,693,0.455,94,236,0.398,221,457,0.484,0.522,192,241,0.797,108,435,543,165,49,32,96,217,916
Ronald Murray\murraro01,PG,28,42,19,874,154,367,0.42,20,63,0.317,134,304,0.441,0.447,68,98,0.694,23,60,83,144,38,4,84,50,396
Ronald Murray\murraro01,PG,28,19,2,347,57,139,0.41,6,27,0.222,51,112,0.455,0.432,22,37,0.595,13,23,36,64,13,1,31,19,142
Ronald Murray\murraro01,PG,28,23,17,527,97,228,0.425,14,36,0.389,83,192,0.432,0.456,46,61,0.754,10,37,47,80,25,3,53,31,254
Dikembe Mutombo*\mutomdi01,C,41,39,25,619,43,80,0.538,0,0,,43,80,0.538,0.538,32,45,0.711,68,131,199,5,11,48,17,55,118
Bostjan Nachbar\nachbbo01,PF,27,75,1,1660,245,609,0.402,94,262,0.359,151,347,0.435,0.479,154,196,0.786,56,204,260,88,44,21,85,182,738
Eduardo Najera\najered01,PF,31,78,3,1664,174,368,0.473,53,147,0.361,121,221,0.548,0.545,63,89,0.708,113,224,337,95,69,40,59,199,464
Steve Nash*\nashst01,PG,33,81,81,2780,485,962,0.504,179,381,0.47,306,581,0.527,0.597,222,245,0.906,28,254,282,898,53,5,295,113,1371
Juan Carlos Navarro\navarju01,SG,27,82,30,2117,308,766,0.402,156,432,0.361,152,334,0.455,0.504,124,146,0.849,34,176,210,177,48,1,134,94,896
Jameer Nelson\nelsoja01,PG,25,69,62,1961,283,603,0.469,64,154,0.416,219,449,0.488,0.522,125,151,0.828,28,215,243,383,63,4,141,167,755
Rasho Nesterovic\nestera01,C,31,71,39,1486,257,467,0.55,1,3,0.333,256,464,0.552,0.551,37,49,0.755,130,212,342,82,20,52,60,132,552
Ira Newble\newblir01,SG-SF,33,49,13,698,76,174,0.437,16,49,0.327,60,125,0.48,0.483,20,26,0.769,47,78,125,18,28,8,34,69,188
Ira Newble\newblir01,SG,33,41,13,650,71,158,0.449,15,45,0.333,56,113,0.496,0.497,20,26,0.769,41,73,114,14,27,7,31,64,177
Ira Newble\newblir01,SF,33,2,0,17,2,7,0.286,0,2,0,2,5,0.4,0.286,0,0,,0,0,0,1,0,0,0,0,4
Ira Newble\newblir01,SF,33,6,0,31,3,9,0.333,1,2,0.5,2,7,0.286,0.389,0,0,,6,5,11,3,1,1,3,5,7
Demetris Nichols\nichode01,SF,23,14,0,44,6,23,0.261,3,13,0.231,3,10,0.3,0.326,0,0,,0,5,5,1,0,3,4,4,15
Demetris Nichols\nichode01,SF,23,3,0,14,1,8,0.125,0,3,0,1,5,0.2,0.125,0,0,,0,1,1,0,0,0,2,0,2
Demetris Nichols\nichode01,SF,23,11,0,30,5,15,0.333,3,10,0.3,2,5,0.4,0.433,0,0,,0,4,4,1,0,3,2,4,13
Joakim Noah\noahjo01,C,22,74,31,1534,177,367,0.482,0,1,0,177,366,0.484,0.482,134,194,0.691,174,242,416,84,68,64,89,173,488
Andres Nocioni\nocioan01,SF,28,82,27,2021,379,877,0.432,126,346,0.364,253,531,0.476,0.504,196,243,0.807,48,294,342,95,25,43,133,245,1080
Steve Novak\novakst01,SF,24,35,0,264,49,102,0.48,34,71,0.479,15,31,0.484,0.647,3,4,0.75,4,31,35,6,2,3,4,17,135
Dirk Nowitzki\nowitdi01,PF,29,77,77,2769,630,1314,0.479,79,220,0.359,551,1094,0.504,0.51,478,544,0.879,95,564,659,266,51,71,160,198,1817
Patrick O'Bryant\obryapa01,C,21,24,0,99,16,29,0.552,0,0,,16,29,0.552,0.552,3,5,0.6,10,19,29,4,4,9,7,27,35
Jermaine O'Neal\onealje01,C,29,42,34,1206,225,512,0.439,0,5,0,225,507,0.444,0.439,121,163,0.742,82,201,283,93,20,87,106,129,571
Shaquille O'Neal*\onealsh01,C,35,61,61,1748,331,558,0.593,0,0,,331,558,0.593,0.593,170,338,0.503,166,388,554,93,32,88,181,228,832
Shaquille O'Neal*\onealsh01,C,35,33,33,945,191,329,0.581,0,0,,191,329,0.581,0.581,88,178,0.494,99,159,258,45,19,54,98,134,470
Shaquille O'Neal*\onealsh01,C,35,28,28,803,140,229,0.611,0,0,,140,229,0.611,0.611,82,160,0.513,67,229,296,48,13,34,83,94,362
Fabricio Oberto\obertfa01,PF,32,82,64,1644,180,296,0.608,0,1,0,180,295,0.61,0.608,37,61,0.607,153,277,430,95,37,20,51,203,397
Lamar Odom\odomla01,PF,28,77,77,2921,417,795,0.525,31,113,0.274,386,682,0.566,0.544,229,328,0.698,197,622,819,273,75,72,156,222,1094
Emeka Okafor\okafoem01,C,25,82,82,2718,460,860,0.535,0,0,,460,860,0.535,0.535,213,374,0.57,255,621,876,70,62,138,164,241,1133
Mehmet Okur\okurme01,C,28,72,72,2390,374,841,0.445,114,294,0.388,260,547,0.475,0.512,185,230,0.804,132,424,556,145,55,29,104,236,1047
Kevin Ollie\ollieke01,SG,35,40,0,300,29,69,0.42,0,1,0,29,68,0.426,0.42,12,15,0.8,4,15,19,38,10,0,5,28,70
Bo Outlaw\outlabo01,PF,36,2,0,7,2,3,0.667,0,0,,2,3,0.667,0.667,0,0,,0,0,0,0,0,0,1,1,4
Travis Outlaw\outlatr01,PF,23,82,6,2186,417,964,0.433,40,101,0.396,377,863,0.437,0.453,218,294,0.741,96,280,376,106,59,63,107,173,1092
Andre Owens\owensan01,PG,27,31,7,392,40,107,0.374,18,40,0.45,22,67,0.328,0.458,25,34,0.735,13,34,47,47,13,3,24,37,123
Zaza Pachulia\pachuza01,C,23,62,5,944,107,245,0.437,0,3,0,107,242,0.442,0.437,108,153,0.706,89,159,248,36,24,13,69,140,322
Jannero Pargo\pargoja01,SG,28,80,5,1497,254,652,0.39,65,186,0.349,189,466,0.406,0.439,71,81,0.877,26,104,130,192,50,5,93,123,644
Anthony Parker\parkean01,SG,32,82,82,2634,395,829,0.476,133,304,0.438,262,525,0.499,0.557,102,125,0.816,50,284,334,183,79,17,87,157,1025
Smush Parker\parkesm01,PG,26,28,2,592,64,184,0.348,18,78,0.231,46,106,0.434,0.397,19,28,0.679,4,47,51,84,24,6,44,60,165
Smush Parker\parkesm01,PG,26,9,0,183,17,54,0.315,6,24,0.25,11,30,0.367,0.37,3,4,0.75,2,17,19,15,5,3,8,13,43
Smush Parker\parkesm01,PG,26,19,2,409,47,130,0.362,12,54,0.222,35,76,0.461,0.408,16,24,0.667,2,30,32,69,19,3,36,47,122
Tony Parker\parketo01,PG,25,69,68,2312,515,1043,0.494,17,66,0.258,498,977,0.51,0.502,248,347,0.715,30,191,221,411,55,8,164,93,1295
Ruben Patterson\patteru01,SF,32,20,5,327,39,86,0.453,0,2,0,39,84,0.464,0.453,24,43,0.558,24,40,64,17,21,7,27,37,102
Chris Paul\paulch01,PG,22,80,80,3006,630,1291,0.488,92,249,0.369,538,1042,0.516,0.524,332,390,0.851,62,259,321,925,217,4,201,185,1684
Sasha Pavlovic\pavloal01,SG,24,51,45,1188,146,403,0.362,34,114,0.298,112,289,0.388,0.404,53,77,0.688,35,93,128,82,29,6,55,117,379
Oleksiy Pecherov\pecheol01,C,22,35,0,320,44,125,0.352,17,60,0.283,27,65,0.415,0.42,20,31,0.645,21,45,66,7,6,5,17,30,125
Kendrick Perkins\perkike01,C,23,78,78,1912,214,348,0.615,0,1,0,214,347,0.617,0.615,114,183,0.623,145,329,474,84,31,114,125,242,542
Kosta Perovic\perovko01,C,22,7,0,38,3,10,0.3,0,0,,3,10,0.3,0.3,4,6,0.667,6,7,13,1,0,2,1,6,10
Morris Peterson\petermo01,SG,30,76,76,1796,215,516,0.417,113,287,0.394,102,229,0.445,0.526,65,85,0.765,36,170,206,67,47,7,41,125,608
Johan Petro\petrojo01,C,22,72,28,1310,184,439,0.419,0,1,0,184,438,0.42,0.419,64,87,0.736,98,272,370,32,35,42,73,173,432
Eric Piatkowski\piatker01,SF,37,16,0,113,12,33,0.364,11,26,0.423,1,7,0.143,0.53,4,4,1,1,11,12,10,0,1,6,11,39
Paul Pierce\piercpa01,SF,30,80,80,2874,509,1098,0.464,143,365,0.392,366,733,0.499,0.529,409,485,0.843,53,358,411,363,101,36,221,200,1570
Mickael Pietrus\pietrmi01,SF,25,66,16,1316,170,387,0.439,66,183,0.361,104,204,0.51,0.525,66,98,0.673,67,175,242,49,66,43,48,200,472
Scot Pollard\pollasc01,C,32,22,0,173,12,23,0.522,0,0,,12,23,0.522,0.522,15,22,0.682,14,23,37,3,3,6,5,43,39
James Posey\poseyja01,PF,31,74,2,1821,173,414,0.418,106,279,0.38,67,135,0.496,0.546,93,115,0.809,30,292,322,114,72,19,65,182,545
Leon Powe\powele01,C,24,56,5,809,154,269,0.572,0,1,0,154,268,0.575,0.572,137,193,0.71,95,132,227,15,15,16,43,127,445
Josh Powell\poweljo01,C,25,64,25,1228,145,315,0.46,0,3,0,145,312,0.465,0.46,63,87,0.724,115,216,331,47,14,23,65,130,353
Kasib Powell\powelka01,SF,26,11,4,304,35,95,0.368,8,33,0.242,27,62,0.435,0.411,6,9,0.667,8,36,44,18,9,2,5,18,84
Ronnie Price\pricero01,PG,24,61,3,588,88,204,0.431,26,75,0.347,62,129,0.481,0.495,26,38,0.684,8,38,46,78,32,3,30,83,228
Tayshaun Prince\princta01,SF,27,82,82,2694,421,940,0.448,53,146,0.363,368,794,0.463,0.476,185,241,0.768,109,289,398,268,42,33,91,90,1080
Gabe Pruitt\pruitga01,PG,21,15,0,95,14,39,0.359,3,12,0.25,11,27,0.407,0.397,1,2,0.5,1,7,8,13,5,0,5,10,32
Joel Przybilla\przybjo01,C,28,77,67,1819,144,250,0.576,0,1,0,144,249,0.578,0.576,83,122,0.68,195,454,649,27,13,93,95,234,371
Chris Quinn\quinnch01,PG,24,60,25,1340,158,373,0.424,64,159,0.403,94,214,0.439,0.509,85,98,0.867,11,107,118,178,46,4,55,90,465
Vladimir Radmanovic\radmavl01,SF,27,65,41,1483,198,437,0.453,95,234,0.406,103,203,0.507,0.562,52,65,0.8,56,159,215,123,46,12,73,147,543
Shavlik Randolph\randosh01,PF,24,9,0,27,4,14,0.286,0,0,,4,14,0.286,0.286,0,0,,9,2,11,3,1,3,2,5,8
Zach Randolph\randoza01,C,26,69,68,2244,486,1058,0.459,22,80,0.275,464,978,0.474,0.47,223,289,0.772,184,526,710,140,59,16,186,194,1217
Theo Ratliff\ratlith01,C-PF,34,26,9,437,41,85,0.482,0,1,0,41,84,0.488,0.482,29,43,0.674,32,57,89,14,7,37,21,59,111
Theo Ratliff\ratlith01,PF,34,10,6,214,23,45,0.511,0,1,0,23,44,0.523,0.511,17,25,0.68,13,26,39,7,3,19,12,30,63
Theo Ratliff\ratlith01,C,34,16,3,223,18,40,0.45,0,0,,18,40,0.45,0.45,12,18,0.667,19,31,50,7,4,18,9,29,48
Michael Redd\reddmi01,SG,28,72,71,2702,550,1243,0.442,130,359,0.362,420,884,0.475,0.495,402,490,0.82,85,224,309,247,65,13,181,120,1632
J.J. Redick\redicjj01,SG,23,34,0,276,48,108,0.444,17,43,0.395,31,65,0.477,0.523,27,34,0.794,1,22,23,16,4,0,15,29,140
Chris Richard\richach01,C,23,52,3,556,41,87,0.471,0,0,,41,87,0.471,0.471,16,27,0.593,52,83,135,18,10,12,24,83,98
Jason Richardson\richaja01,SF,27,82,82,3149,648,1468,0.441,243,599,0.406,405,869,0.466,0.524,249,331,0.752,80,361,441,258,116,57,166,241,1788
Jeremy Richardson\richaje01,SF-SG,23,27,1,132,16,44,0.364,7,19,0.368,9,25,0.36,0.443,2,2,1,1,8,9,2,3,0,6,13,41
Jeremy Richardson\richaje01,SF,23,3,0,15,0,6,0,0,2,0,0,4,0,0,0,0,,0,1,1,1,0,0,1,2,0
Jeremy Richardson\richaje01,SG,23,5,1,29,3,7,0.429,2,5,0.4,1,2,0.5,0.571,2,2,1,0,1,1,1,1,0,0,5,10
Jeremy Richardson\richaje01,SF,23,19,0,88,13,31,0.419,5,12,0.417,8,19,0.421,0.5,0,0,,1,6,7,0,2,0,5,6,31
Quentin Richardson\richaqu01,SF,27,65,65,1841,199,555,0.359,69,214,0.322,130,341,0.381,0.421,60,88,0.682,56,259,315,116,44,15,69,153,527
Luke Ridnour\ridnolu01,PG,26,61,5,1223,147,368,0.399,21,71,0.296,126,297,0.424,0.428,78,91,0.857,13,81,94,241,37,14,80,120,393
Nate Robinson\robinna01,PG,23,72,17,1883,331,782,0.423,97,292,0.332,234,490,0.478,0.485,154,196,0.786,51,171,222,212,60,1,103,186,913
Sergio Rodriguez\rodrise01,PG,21,72,0,628,69,196,0.352,17,58,0.293,52,138,0.377,0.395,25,38,0.658,13,45,58,123,24,0,53,57,180
Rajon Rondo\rondora01,PG,21,77,77,2306,351,713,0.492,5,19,0.263,346,694,0.499,0.496,107,175,0.611,78,244,322,393,129,13,147,187,814
Malik Rose\rosema01,PF,33,49,3,494,66,180,0.367,2,7,0.286,64,173,0.37,0.372,37,51,0.725,31,72,103,28,16,7,40,80,171
Quinton Ross\rossqu01,SG,26,76,44,1505,131,335,0.391,9,21,0.429,122,314,0.389,0.404,40,60,0.667,54,118,172,88,43,33,29,132,311
Brandon Roy\roybr01,SG,23,74,74,2792,531,1170,0.454,73,215,0.34,458,955,0.48,0.485,281,373,0.753,81,267,348,430,79,16,136,147,1416
Michael Ruffin\ruffimi01,C,31,46,2,632,33,62,0.532,0,0,,33,62,0.532,0.532,25,63,0.397,90,96,186,24,31,19,19,93,91
Kareem Rush\rushka01,SG,27,71,15,1504,228,569,0.401,102,262,0.389,126,307,0.41,0.49,30,42,0.714,19,149,168,89,42,19,62,108,588
John Salmons\salmojo01,SG,28,81,41,2517,381,799,0.477,39,120,0.325,342,679,0.504,0.501,214,260,0.823,76,273,349,208,93,31,170,171,1015
Cheikh Samb\sambch01,C,23,4,0,31,3,4,0.75,0,0,,3,4,0.75,0.75,1,2,0.5,3,4,7,0,1,2,1,8,7
Brian Scalabrine\scalabr01,PF,29,48,9,512,29,94,0.309,15,46,0.326,14,48,0.292,0.388,15,20,0.75,22,57,79,40,9,8,26,63,88
Luis Scola\scolalu01,PF,27,82,39,2024,345,670,0.515,0,3,0,345,667,0.517,0.515,157,235,0.668,174,351,525,106,60,19,105,235,847
Thabo Sefolosha\sefolth01,SG,23,69,22,1436,180,421,0.428,29,88,0.33,151,333,0.453,0.462,75,104,0.721,50,205,255,129,61,30,93,128,464
Mouhamed Sene\senesa01,C,21,13,0,62,11,24,0.458,0,0,,11,24,0.458,0.458,8,17,0.471,7,9,16,1,0,7,0,9,30
Ramon Sessions\sessira01,PG,21,17,7,450,51,117,0.436,3,7,0.429,48,110,0.436,0.449,32,41,0.78,8,50,58,127,17,3,36,26,137
Bobby Simmons\simmobo01,SF,27,70,21,1521,209,496,0.421,60,171,0.351,149,325,0.458,0.482,53,70,0.757,67,159,226,80,50,5,78,140,531
Cedric Simmons\simmoce01,PF,22,14,0,87,4,14,0.286,0,0,,4,14,0.286,0.286,0,10,0,6,12,18,0,2,5,6,8,8
Cedric Simmons\simmoce01,PF,22,7,0,68,2,6,0.333,0,0,,2,6,0.333,0.333,0,8,0,5,10,15,0,2,5,4,7,4
Cedric Simmons\simmoce01,PF,22,7,0,19,2,8,0.25,0,0,,2,8,0.25,0.25,0,2,0,1,2,3,0,0,0,2,1,4
Courtney Sims\simsco01,C,24,3,0,11,0,1,0,0,0,,0,1,0,0,0,0,,1,1,2,1,0,0,0,2,0
Brian Skinner\skinnbr01,C,31,66,0,844,92,198,0.465,2,3,0.667,90,195,0.462,0.47,33,63,0.524,63,175,238,15,21,77,39,112,219
Craig Smith\smithcr01,PF,24,77,11,1547,297,528,0.563,0,9,0,297,519,0.572,0.563,133,200,0.665,123,230,353,60,36,17,89,217,727
J.R. Smith\smithjr01,SG,22,74,0,1421,311,674,0.461,157,390,0.403,154,284,0.542,0.578,128,178,0.719,43,109,152,128,62,12,112,144,907
Jason Smith\smithja02,PF,21,76,1,1107,141,310,0.455,4,14,0.286,137,296,0.463,0.461,54,82,0.659,77,153,230,20,22,50,48,142,340
Joe Smith\smithjo02,PF,32,77,36,1726,312,653,0.478,0,3,0,312,650,0.48,0.478,154,204,0.755,163,238,401,66,34,47,71,186,778
Joe Smith\smithjo02,PF,32,50,35,1146,225,483,0.466,0,1,0,225,482,0.467,0.466,109,135,0.807,108,157,265,47,25,31,49,113,559
Joe Smith\smithjo02,PF,32,27,1,580,87,170,0.512,0,2,0,87,168,0.518,0.512,45,69,0.652,55,81,136,19,9,16,22,73,219
Josh Smith\smithjo03,PF,22,81,81,2873,518,1133,0.457,25,99,0.253,493,1034,0.477,0.468,333,469,0.71,161,506,667,272,123,227,245,269,1394
Eric Snow\snower01,PG,34,22,5,305,6,38,0.158,0,2,0,6,36,0.167,0.158,10,22,0.455,4,16,20,42,10,4,10,30,22
Kirk Snyder\snydeki01,SF-PF,24,36,18,761,96,189,0.508,5,23,0.217,91,166,0.548,0.521,64,88,0.727,30,96,126,64,20,15,52,55,261
Kirk Snyder\snydeki01,PF,24,9,0,81,13,28,0.464,2,9,0.222,11,19,0.579,0.5,6,11,0.545,5,7,12,8,1,1,4,6,34
Kirk Snyder\snydeki01,SF,24,27,18,680,83,161,0.516,3,14,0.214,80,147,0.544,0.525,58,77,0.753,25,89,114,56,19,14,48,49,227
Darius Songaila\songada01,C,29,80,13,1554,214,467,0.458,0,2,0,214,465,0.46,0.458,67,73,0.918,81,190,271,135,53,16,86,181,495
Jerry Stackhouse\stackje01,SG,33,58,13,1412,213,526,0.405,60,184,0.326,153,342,0.447,0.462,132,148,0.892,33,100,133,145,28,10,86,82,618
DeShawn Stevenson\stevede01,SG,26,82,82,2564,301,780,0.386,158,413,0.383,143,367,0.39,0.487,157,197,0.797,37,198,235,252,65,15,102,110,917
Peja Stojakovic\stojape01,SF,30,77,77,2711,451,1026,0.44,231,524,0.441,220,502,0.438,0.552,130,140,0.929,64,267,331,96,57,10,61,127,1263
Awvee Storey\storeaw01,SG,30,26,0,259,39,89,0.438,0,7,0,39,82,0.476,0.438,14,29,0.483,31,23,54,16,7,1,10,41,92
Damon Stoudamire\stoudda01,PG,34,60,33,1037,120,337,0.356,50,149,0.336,70,188,0.372,0.43,27,34,0.794,20,98,118,165,30,2,80,76,317
Damon Stoudamire\stoudda01,PG,34,29,29,624,77,194,0.397,36,94,0.383,41,100,0.41,0.49,21,26,0.808,14,57,71,112,19,0,50,46,211
Damon Stoudamire\stoudda01,PG,34,31,4,413,43,143,0.301,14,55,0.255,29,88,0.33,0.35,6,8,0.75,6,41,47,53,11,2,30,30,106
Salim Stoudamire\stoudsa01,PG,25,35,0,402,65,180,0.361,29,85,0.341,36,95,0.379,0.442,41,50,0.82,4,20,24,28,7,5,21,34,200
Amar'e Stoudemire\stoudam01,C,25,79,79,2677,714,1211,0.59,5,31,0.161,709,1180,0.601,0.592,556,691,0.805,178,541,719,118,64,163,174,294,1989
D.J. Strawberry\strawdj01,SG,22,33,0,270,29,92,0.315,6,25,0.24,23,67,0.343,0.348,9,19,0.474,9,19,28,30,12,6,11,36,73
Rodney Stuckey\stuckro01,PG,21,57,2,1081,153,382,0.401,3,16,0.188,150,366,0.41,0.404,127,156,0.814,32,97,129,160,49,6,78,113,436
Robert Swift\swiftro01,C,22,8,4,98,6,17,0.353,0,0,,6,17,0.353,0.353,2,2,1,6,12,18,1,5,6,10,16,14
Stromile Swift\swiftst01,PF,28,56,4,844,135,265,0.509,0,2,0,135,263,0.513,0.509,73,109,0.67,64,135,199,26,15,54,51,113,343
Stromile Swift\swiftst01,PF,28,35,4,549,93,177,0.525,0,2,0,93,175,0.531,0.525,52,81,0.642,46,83,129,22,10,36,39,74,238
Stromile Swift\swiftst01,PF,28,21,0,295,42,88,0.477,0,0,,42,88,0.477,0.477,21,28,0.75,18,52,70,4,5,18,12,39,105
Wally Szczerbiak\szczewa02,SF,30,75,2,1736,311,722,0.431,90,218,0.413,221,504,0.438,0.493,149,175,0.851,34,183,217,104,23,12,76,103,861
Wally Szczerbiak\szczewa02,SF,30,50,1,1180,236,513,0.46,71,166,0.428,165,347,0.476,0.529,113,134,0.843,16,120,136,69,14,5,56,67,656
Wally Szczerbiak\szczewa02,SF,30,25,1,556,75,209,0.359,19,52,0.365,56,157,0.357,0.404,36,41,0.878,18,63,81,35,9,7,20,36,205
Sebastian Telfair\telfase01,PG,22,60,51,1933,223,556,0.401,32,114,0.281,191,442,0.432,0.43,78,105,0.743,16,119,135,355,59,11,111,171,556
Jason Terry\terryja01,SG,30,82,34,2579,471,1008,0.467,136,363,0.375,335,645,0.519,0.535,191,223,0.857,30,178,208,264,88,18,92,170,1269
Billy Thomas\thomabi01,SF,32,11,0,42,4,17,0.235,4,16,0.25,0,1,0,0.353,2,2,1,0,2,2,0,1,0,4,4,14
Billy Thomas\thomabi01,SF,32,4,0,8,0,3,0,0,3,0,0,0,,0,2,2,1,0,0,0,0,0,0,1,0,2
Billy Thomas\thomabi01,SF,32,7,0,34,4,14,0.286,4,13,0.308,0,1,0,0.429,0,0,,0,2,2,0,1,0,3,4,12
Kenny Thomas\thomake01,PF,30,23,3,281,16,38,0.421,0,0,,16,38,0.421,0.421,0,5,0,18,43,61,13,6,1,21,38,32
Kurt Thomas\thomaku01,C-PF,35,70,48,1584,195,396,0.492,0,1,0,195,395,0.494,0.492,53,80,0.663,130,377,507,67,56,57,46,188,443
Kurt Thomas\thomaku01,C,35,42,39,1060,139,271,0.513,0,0,,139,271,0.513,0.513,39,56,0.696,94,275,369,53,35,43,28,131,317
Kurt Thomas\thomaku01,PF,35,28,9,524,56,125,0.448,0,1,0,56,124,0.452,0.448,14,24,0.583,36,102,138,14,21,14,18,57,126
Tim Thomas\thomati01,PF,30,63,51,1940,291,705,0.413,83,271,0.306,208,434,0.479,0.472,115,153,0.752,62,261,323,171,40,29,98,192,780
Tyrus Thomas\thomaty01,PF,21,74,27,1330,186,440,0.423,1,6,0.167,185,434,0.426,0.424,129,174,0.741,102,240,342,90,48,72,77,170,502
Al Thornton\thornal01,PF,24,79,31,2158,374,871,0.429,43,130,0.331,331,741,0.447,0.454,214,288,0.743,98,260,358,98,46,43,128,195,1005
Jamaal Tinsley\tinslja01,PG,29,39,36,1293,176,463,0.38,40,141,0.284,136,322,0.422,0.423,72,100,0.72,24,117,141,326,66,10,130,97,464
Alando Tucker\tuckeal02,SF,23,6,0,48,8,22,0.364,1,4,0.25,7,18,0.389,0.386,5,6,0.833,4,4,8,0,0,1,0,2,22
Ronny Turiaf\turiaro01,C,25,78,21,1458,188,397,0.474,0,1,0,188,396,0.475,0.474,140,186,0.753,95,211,306,128,28,108,72,199,516
Hedo Turkoglu\turkohe01,SF,28,82,82,3026,556,1219,0.456,166,415,0.4,390,804,0.485,0.524,324,391,0.829,83,388,471,409,74,25,246,244,1602
Ime Udoka\udokaim01,PF,30,73,0,1316,159,375,0.424,61,165,0.37,98,210,0.467,0.505,44,58,0.759,36,192,228,63,56,17,58,127,423
Beno Udrih\udrihbe01,PG,25,65,51,2080,328,708,0.463,53,137,0.387,275,571,0.482,0.501,125,147,0.85,34,183,217,282,56,10,148,138,834
Anderson Varejao\varejan01,C,25,48,13,1320,136,295,0.461,0,2,0,136,293,0.464,0.461,49,82,0.598,134,265,399,53,37,26,59,134,321
Jacque Vaughn\vaughja01,PG,32,74,9,1139,121,283,0.428,3,10,0.3,118,273,0.432,0.433,61,80,0.763,13,61,74,159,23,1,54,97,306
Charlie Villanueva\villach01,PF,23,76,31,1829,354,814,0.435,55,185,0.297,299,629,0.475,0.469,123,157,0.783,145,321,466,78,30,35,107,174,886
Marcus Vinicius\vincima01,SF,23,13,0,69,9,20,0.45,5,12,0.417,4,8,0.5,0.575,5,11,0.455,1,7,8,2,1,1,3,4,28
Jake Voskuhl\voskuja01,C,30,44,0,386,37,80,0.463,0,0,,37,80,0.463,0.463,24,29,0.828,30,67,97,13,9,21,29,83,98
Sasha Vujacic\vujacsa01,SG,23,72,0,1279,219,482,0.454,118,270,0.437,101,212,0.476,0.577,76,91,0.835,19,135,154,72,36,5,52,107,632
Dwyane Wade\wadedw01,SG,26,51,49,1954,439,937,0.469,22,77,0.286,417,860,0.485,0.48,354,467,0.758,45,169,214,354,87,37,224,137,1254
Von Wafer\wafervo01,SG,22,29,0,154,17,61,0.279,4,26,0.154,13,35,0.371,0.311,8,12,0.667,1,18,19,7,2,3,13,7,46
Von Wafer\wafervo01,SG,22,21,0,90,10,38,0.263,1,15,0.067,9,23,0.391,0.276,6,8,0.75,1,9,10,5,2,1,11,4,27
Von Wafer\wafervo01,SG,22,8,0,64,7,23,0.304,3,11,0.273,4,12,0.333,0.37,2,4,0.5,0,9,9,2,0,2,2,3,19
Antoine Walker\walkean02,PF,31,46,1,892,136,375,0.363,61,188,0.324,75,187,0.401,0.444,35,66,0.53,56,112,168,45,33,8,46,80,368
Ben Wallace\wallabe01,C-PF,33,72,72,2205,138,352,0.392,0,4,0,138,348,0.397,0.392,72,169,0.426,234,370,604,105,88,117,67,121,348
Ben Wallace\wallabe01,C,33,50,50,1627,101,271,0.373,0,4,0,101,267,0.378,0.373,53,125,0.424,175,266,441,92,69,80,49,86,255
Ben Wallace\wallabe01,PF,33,22,22,578,37,81,0.457,0,0,,37,81,0.457,0.457,19,44,0.432,59,104,163,13,19,37,18,35,93
Gerald Wallace\wallage01,PF,25,62,59,2376,408,908,0.449,71,221,0.321,337,687,0.491,0.488,313,428,0.731,58,315,373,216,131,58,180,189,1200
Rasheed Wallace\wallara01,C,33,77,76,2346,376,870,0.432,112,315,0.356,264,555,0.476,0.497,115,150,0.767,84,427,511,137,91,129,86,213,979
Luke Walton\waltolu01,SF,27,74,31,1729,215,478,0.45,28,84,0.333,187,394,0.475,0.479,77,109,0.706,85,206,291,218,60,18,100,133,535
Hakim Warrick\warriha01,PF,25,75,30,1754,328,653,0.502,13,48,0.271,315,605,0.521,0.512,183,260,0.704,123,233,356,53,36,28,85,156,852
Darius Washington\washida01,SG,22,18,0,146,21,48,0.438,4,12,0.333,17,36,0.472,0.479,7,13,0.538,4,16,20,15,5,0,14,16,53
Darryl Watkins\watkida01,C,23,9,0,71,5,15,0.333,0,0,,5,15,0.333,0.333,2,5,0.4,5,7,12,0,2,2,7,8,12
C.J. Watson\watsocj01,PG,23,32,0,368,43,101,0.426,9,26,0.346,34,75,0.453,0.47,23,29,0.793,13,19,32,35,15,0,18,19,118
Earl Watson\watsoea01,PG,28,78,73,2269,339,747,0.454,49,132,0.371,290,615,0.472,0.487,111,145,0.766,43,182,225,531,69,11,175,158,838
Chris Webber\webbech01,PF,34,9,8,126,15,31,0.484,0,0,,15,31,0.484,0.484,5,12,0.417,2,30,32,18,4,6,11,17,35
Martell Webster\webstma02,SF,21,75,70,2132,277,656,0.422,123,317,0.388,154,339,0.454,0.516,122,166,0.735,54,242,296,90,42,28,83,159,799
Bonzi Wells\wellsbo01,SG,31,73,7,1562,252,569,0.443,12,50,0.24,240,519,0.462,0.453,146,227,0.643,84,247,331,97,75,32,103,157,662
Bonzi Wells\wellsbo01,SG,31,51,7,1124,175,412,0.425,8,38,0.211,167,374,0.447,0.434,111,174,0.638,63,197,260,80,51,24,76,113,469
Bonzi Wells\wellsbo01,SG,31,22,0,438,77,157,0.49,4,12,0.333,73,145,0.503,0.503,35,53,0.66,21,50,71,17,24,8,27,44,193
David West\westda01,PF,27,76,76,2870,629,1305,0.482,6,25,0.24,623,1280,0.487,0.484,300,353,0.85,180,495,675,177,62,99,165,208,1564
Delonte West\westde01,PG,24,61,31,1533,196,475,0.413,48,135,0.356,148,340,0.435,0.463,67,91,0.736,31,162,193,229,59,29,117,103,507
Delonte West\westde01,PG,24,35,5,727,97,250,0.388,19,56,0.339,78,194,0.402,0.426,26,39,0.667,13,83,96,113,30,10,66,44,239
Delonte West\westde01,PG,24,26,26,806,99,225,0.44,29,79,0.367,70,146,0.479,0.504,41,52,0.788,18,79,97,116,29,19,51,59,268
Mario West\westma02,SG,23,64,2,269,21,49,0.429,0,4,0,21,45,0.467,0.429,17,26,0.654,26,22,48,13,12,4,9,61,59
Chris Wilcox\wilcoch01,PF,25,62,55,1739,334,638,0.524,0,3,0,334,635,0.526,0.524,160,248,0.645,126,307,433,74,46,36,103,174,828
Damien Wilkins\wilkida02,SF,28,76,31,1843,271,673,0.403,50,155,0.323,221,518,0.427,0.44,106,144,0.736,72,173,245,150,62,19,89,128,698
Mike Wilks\wilksmi01,PG,28,15,0,188,17,36,0.472,3,8,0.375,14,28,0.5,0.514,4,4,1,5,14,19,14,9,0,9,13,41
Mike Wilks\wilksmi01,PG,28,8,0,122,10,23,0.435,2,5,0.4,8,18,0.444,0.478,2,2,1,4,8,12,6,5,0,5,9,24
Mike Wilks\wilksmi01,PG,28,4,0,44,2,4,0.5,1,2,0.5,1,2,0.5,0.625,0,0,,1,5,6,3,3,0,1,2,5
Mike Wilks\wilksmi01,PG,28,3,0,22,5,9,0.556,0,1,0,5,8,0.625,0.556,2,2,1,0,1,1,5,1,0,3,2,12
Aaron Williams\williaa01,C,36,30,5,297,27,55,0.491,0,0,,27,55,0.491,0.491,14,18,0.778,15,46,61,9,12,15,13,44,68
Deron Williams\willide01,PG,23,82,82,3059,566,1117,0.507,83,210,0.395,483,907,0.533,0.544,330,411,0.803,34,209,243,862,90,23,279,200,1545
Jason Williams\willija02,PG,32,67,53,1886,211,550,0.384,97,275,0.353,114,275,0.415,0.472,69,80,0.863,12,118,130,307,83,5,91,93,588
Justin Williams\williju01,C,23,23,0,123,13,29,0.448,0,0,,13,29,0.448,0.448,8,26,0.308,20,29,49,0,5,5,4,17,34
Justin Williams\williju01,C,23,22,0,117,12,26,0.462,0,0,,12,26,0.462,0.462,7,22,0.318,19,29,48,0,5,5,3,14,31
Justin Williams\williju01,C,23,1,0,6,1,3,0.333,0,0,,1,3,0.333,0.333,1,4,0.25,1,0,1,0,0,0,1,3,3
Lou Williams\willilo02,PG,21,80,0,1862,319,752,0.424,55,153,0.359,264,599,0.441,0.461,227,290,0.783,41,126,167,253,81,13,125,130,920
Marcus Williams\willima03,PG,22,53,7,854,111,293,0.379,54,142,0.38,57,151,0.377,0.471,37,47,0.787,14,87,101,140,25,3,75,52,313
Marcus Williams\willima04,PF-SF,21,11,0,36,5,20,0.25,0,0,,5,20,0.25,0.25,0,0,,4,8,12,3,1,1,0,3,10
Marcus Williams\willima04,SF,21,1,0,2,0,1,0,0,0,,0,1,0,0,0,0,,0,0,0,0,0,1,0,0,0
Marcus Williams\willima04,PF,21,10,0,34,5,19,0.263,0,0,,5,19,0.263,0.263,0,0,,4,8,12,3,1,0,0,3,10
Marvin Williams\willima02,SF,21,80,80,2765,424,918,0.462,1,10,0.1,423,908,0.466,0.462,336,409,0.822,119,338,457,137,81,33,127,225,1185
Mo Williams\willima01,PG,25,66,66,2410,441,919,0.48,89,231,0.385,352,688,0.512,0.528,166,194,0.856,37,193,230,419,78,10,182,188,1137
Sean Williams\willise01,C,21,73,29,1278,164,305,0.538,0,0,,164,305,0.538,0.538,81,133,0.609,115,207,322,28,28,106,70,193,409
Shawne Williams\willish03,SF,21,65,3,967,159,372,0.427,43,137,0.314,116,235,0.494,0.485,76,106,0.717,54,122,176,59,26,26,58,132,437
Shelden Williams\willish02,PF,24,64,0,776,92,212,0.434,0,2,0,92,210,0.438,0.434,71,105,0.676,68,137,205,19,22,21,35,110,255
Shelden Williams\willish02,PF,24,36,0,414,37,100,0.37,0,1,0,37,99,0.374,0.37,35,51,0.686,34,73,107,11,13,11,14,60,109
Shelden Williams\willish02,PF,24,28,0,362,55,112,0.491,0,1,0,55,111,0.495,0.491,36,54,0.667,34,64,98,8,9,10,21,50,146
Loren Woods\woodslo01,C,29,7,0,17,3,5,0.6,0,0,,3,5,0.6,0.6,0,0,,0,1,1,2,0,0,0,2,6
Metta World Peace\artesro01,SF,28,57,54,2172,436,962,0.453,84,221,0.38,352,741,0.475,0.497,212,295,0.719,101,227,328,199,133,38,148,159,1168
Antoine Wright\wrighan01,SG,23,56,10,1232,136,329,0.413,32,110,0.291,104,219,0.475,0.462,46,67,0.687,40,107,147,80,28,21,50,127,350
Antoine Wright\wrighan01,SG,23,41,10,1056,115,287,0.401,27,101,0.267,88,186,0.473,0.448,41,58,0.707,35,90,125,67,26,17,39,105,298
Antoine Wright\wrighan01,SG,23,15,0,176,21,42,0.5,5,9,0.556,16,33,0.485,0.56,5,9,0.556,5,17,22,13,2,4,11,22,52
Brandan Wright\wrighbr03,PF,20,38,6,376,62,112,0.554,0,0,,62,112,0.554,0.554,27,40,0.675,38,61,99,9,6,22,13,36,151
Dorell Wright\wrighdo01,SF,22,44,34,1104,143,293,0.488,4,11,0.364,139,282,0.493,0.495,57,69,0.826,48,172,220,60,29,41,29,79,347
Julian Wright\wrighju01,SF,20,57,1,640,90,169,0.533,10,24,0.417,80,145,0.552,0.562,33,52,0.635,33,84,117,40,29,12,34,43,223
Lorenzen Wright\wrighlo02,C,32,18,1,161,6,21,0.286,0,0,,6,21,0.286,0.286,3,6,0.5,8,30,38,4,3,3,4,31,15
Lorenzen Wright\wrighlo02,C,32,13,1,148,5,17,0.294,0,0,,5,17,0.294,0.294,3,6,0.5,7,30,37,3,3,3,2,26,13
Lorenzen Wright\wrighlo02,C,32,5,0,13,1,4,0.25,0,0,,1,4,0.25,0.25,0,0,,1,0,1,1,0,0,2,5,2
Nick Young\youngni01,SG,22,75,2,1158,210,478,0.439,40,100,0.4,170,378,0.45,0.481,101,124,0.815,23,92,115,63,35,7,94,130,561
Thaddeus Young\youngth01,PF,19,74,22,1554,264,490,0.539,6,19,0.316,258,471,0.548,0.545,76,103,0.738,120,192,312,58,73,8,64,126,610